,home-wins,home-draws,home-losses,home-played,home-scored,home-conceived,away-wins,away-draws,away-losses,away-played,away-scored,away-conceived
Kingstonian,67,35,56,158,253,220,59,35,66,160,226,245
DC United,49,23,26,98,161,121,20,27,49,96,98,162
Magny AS,0,0,1,1,1,6,0,0,0,0,0,0
Linense,5,1,3,9,15,12,3,2,3,8,9,12
USSA Vertou,0,0,1,1,1,3,0,0,0,0,0,0
Cove,0,0,1,1,0,5,0,0,0,0,0,0
Annan,74,36,44,154,288,220,51,25,78,154,203,252
Rohrbach,0,0,1,1,0,4,0,0,0,0,0,0
Burgos,1,0,2,3,4,5,0,0,1,1,1,2
AFC Liverpool,0,0,1,1,0,6,0,0,1,1,0,3
St Lucia,0,0,3,3,2,11,1,0,0,1,3,1
Mons Calpe,1,0,2,3,2,9,0,2,0,2,3,3
Macclesfield,68,50,43,161,211,171,57,38,75,170,211,250
Kickers Off.,1,1,2,4,3,5,0,0,1,1,0,5
Marseille II,0,1,1,2,0,3,0,0,1,1,0,2
Highgate United,1,0,2,3,6,7,2,1,1,4,8,7
Grantham,63,37,50,150,235,216,45,32,72,149,189,266
Swansea,81,36,57,174,250,199,52,42,81,175,203,264
KAS Eupen,30,25,36,91,128,156,20,19,53,92,98,184
Flora Tallinn,10,4,4,18,28,15,8,2,8,18,60,27
IB Keflavik,0,2,3,5,4,12,0,1,0,1,1,1
Crediton United,0,0,0,0,0,0,0,0,1,1,1,3
PSG II,1,0,0,1,2,1,0,0,0,0,0,0
Zirka,12,10,10,32,31,31,4,7,21,32,20,52
Keith,13,9,35,57,98,139,16,6,34,56,84,141
SC Verl,6,3,2,11,14,6,2,1,2,5,11,9
Snodland Town,0,0,0,0,0,0,0,0,1,1,1,5
1874 Northwich,8,0,4,12,26,18,4,1,2,7,13,7
Al Ahly,0,1,1,2,0,2,1,0,0,1,1,0
Sanremo,0,0,0,0,0,0,0,0,2,2,0,2
Lincoln R I,18,7,5,30,92,29,14,0,10,24,57,30
FC Tukums,0,0,0,0,0,0,0,0,1,1,2,5
Real Oviedo,65,41,24,130,185,122,30,35,65,130,124,186
Radnik Bijeljina,2,0,6,8,5,13,1,1,3,5,5,8
Wolfsburg,76,40,38,154,262,185,69,36,60,165,244,233
Valencia,97,49,35,181,319,191,60,46,81,187,229,261
Metalist,12,12,12,36,43,50,7,13,14,34,35,53
Italy Women,4,0,2,6,11,6,2,1,0,3,8,2
Vasas,19,9,23,51,65,73,14,11,26,51,59,90
Kasimpasa,56,31,44,131,221,191,32,32,65,129,163,218
Canet Roussillon FC,3,3,2,8,9,7,1,2,1,4,5,6
FC Neftochimik,10,3,12,25,33,36,2,5,17,24,15,53
Punjab United,0,0,1,1,0,3,0,0,0,0,0,0
Bray,47,23,45,115,147,155,27,24,63,114,110,201
Sassuolo,59,49,51,159,240,218,48,36,66,150,191,242
Kings Langley,29,16,28,73,113,111,17,18,40,75,98,151
Enfield Borough,1,0,2,3,8,12,0,0,0,0,0,0
Gonsenheim,0,0,1,1,0,3,0,0,0,0,0,0
City of Liverpool,1,1,1,3,9,3,3,0,4,7,8,15
Savona,1,0,0,1,6,0,0,0,1,1,1,2
Avellino,3,0,1,4,6,1,2,2,6,10,12,20
Brora Rangers,53,4,14,71,220,61,48,10,17,75,194,74
Borac Cacak,26,18,28,72,84,85,11,13,46,70,51,118
Malatyaspor,28,22,22,72,106,85,16,19,37,72,75,111
Leeds U21,0,0,0,0,0,0,0,1,2,3,2,12
AFC Blackpool,0,0,0,0,0,0,0,0,1,1,3,4
Anguilla,0,0,2,2,0,9,0,0,3,3,0,12
Renate,2,1,1,4,5,4,1,2,3,6,7,11
South Korea,31,14,9,54,91,42,18,8,16,42,49,48
Kidlington,4,2,3,9,24,19,3,2,2,7,13,13
Torpedo Zh,57,29,25,111,153,97,43,31,40,114,148,134
Stalybridge,46,30,71,147,208,269,34,31,82,147,151,254
Uxbridge,5,1,5,11,24,19,0,1,2,3,3,7
FC Bolsover,0,0,1,1,1,3,0,0,0,0,0,0
White Ensign,1,0,1,2,6,6,0,0,0,0,0,0
FC Aarau,10,4,14,28,37,45,4,11,12,27,26,55
Armenia U21,0,0,0,0,0,0,0,1,0,1,0,0
Dunfermline,78,38,42,158,281,166,59,42,63,164,227,213
Tosno,2,5,8,15,15,24,4,1,10,15,8,30
Levante,67,45,43,155,209,196,38,42,82,162,169,256
Club America,5,4,3,12,20,12,5,3,2,10,26,12
St. Omer,0,1,2,3,2,8,0,0,1,1,1,3
Ashington,0,0,2,2,2,4,2,0,3,5,11,11
FCI Levadia,1,0,0,1,3,2,0,0,2,2,4,6
Motherwell,71,29,63,163,258,216,57,28,78,163,190,267
Merani-91 Tbilisi,0,1,0,1,1,1,0,0,0,0,0,0
VfB Lubeck,0,1,2,3,4,8,0,0,0,0,0,0
Portadown,31,16,36,83,121,127,20,14,48,82,87,165
New Salamis,0,0,1,1,1,6,0,0,1,1,1,3
Nice,78,31,50,159,230,182,48,45,68,161,186,229
Versailles,0,0,1,1,1,2,0,0,0,0,0,0
Angels FC,0,0,0,0,0,0,0,0,1,1,1,13
Pogon Szczecin,56,43,33,132,190,141,37,42,56,135,144,196
New Caledonia,4,2,1,7,13,8,2,3,3,8,9,12
Eend. Aalst,0,0,1,1,0,4,0,0,0,0,0,0
Mladost Lucani,61,33,29,123,173,132,33,28,63,124,113,193
Ballynanty Rovers,0,0,1,1,0,4,0,0,0,0,0,0
Tow Law Town,1,0,0,1,2,1,0,0,1,1,1,9
Dunston UTS,8,0,8,16,25,25,6,2,1,9,20,10
Malta U21,0,0,1,1,0,4,0,0,0,0,0,0
Lori,0,1,0,1,2,2,0,0,0,0,0,0
Arsenal Tula,36,23,33,92,114,106,21,14,57,92,68,152
N Macedonia,17,4,13,34,57,40,7,10,13,30,27,39
Portsmouth U21,0,0,0,0,0,0,0,1,0,1,0,0
Din Zagreb,136,22,23,181,389,129,103,44,36,183,309,163
Sp Subotica,62,30,40,132,185,149,35,31,65,131,142,200
Frattese,0,0,0,0,0,0,0,0,1,1,0,1
Energetik B.,0,0,1,1,1,2,0,0,0,0,0,0
Lutterworth T,1,1,1,3,11,8,2,0,1,3,6,5
Stansfeld,0,1,1,2,2,5,0,0,0,0,0,0
Anaitasuna,0,0,1,1,1,2,1,0,0,1,2,0
Mjallby,17,8,10,35,50,39,9,7,18,34,39,57
Drenica Skenderaj,0,0,1,1,1,3,0,0,0,0,0,0
Linlithgow Rose,9,1,4,14,37,20,15,2,9,26,56,48
South Park,2,2,2,6,16,16,5,2,4,11,24,25
Gresley Rovers,5,0,3,8,14,7,0,1,3,4,2,11
New Milton Town,1,1,1,3,3,6,0,0,1,1,0,2
Armthorpe Welf,0,0,0,0,0,0,0,0,1,1,0,8
Guichen,0,0,2,2,1,3,0,0,0,0,0,0
24 Erzincanspor,0,0,0,0,0,0,0,0,1,1,0,3
Ambrosiana,0,0,0,0,0,0,0,0,1,1,0,4
Ajax,126,24,21,171,446,133,99,43,31,173,360,169
Bitton,5,0,0,5,17,4,1,0,3,4,8,8
Akademija Pandev,0,0,2,2,0,5,0,0,3,3,2,9
Frimley Green,0,0,2,2,0,4,0,0,0,0,0,0
Conquense,0,0,0,0,0,0,0,0,2,2,0,3
Olympique d'Ales,1,0,2,3,5,5,3,0,1,4,9,2
AFC Mansfield,3,3,3,9,14,15,7,1,4,12,22,15
AEK Larnaca,26,7,7,40,68,29,17,13,12,42,56,54
Tranent,0,0,0,0,0,0,1,0,0,1,4,2
AthlÃ©tico Marseille,0,1,0,1,0,0,0,0,0,0,0,0
Shkendija,25,6,7,38,83,33,20,7,13,40,65,48
W Casablanca,0,0,1,1,2,3,0,0,1,1,0,1
Santarcangelo,0,0,1,1,0,1,0,0,1,1,0,1
AC Bobigny,0,0,1,1,0,3,1,0,1,2,2,1
St Helens Town,1,0,1,2,5,5,1,0,0,1,6,4
Beitar J'salem,65,41,36,142,211,153,54,38,51,143,191,176
Mariehamn,49,28,37,114,165,151,32,29,49,110,104,160
Glentoran,62,30,46,138,213,160,54,37,53,144,217,212
Bergerac,0,1,0,1,1,1,0,0,0,0,0,0
Shirebrook,1,0,1,2,2,3,0,0,2,2,2,7
Balmazujvarosi,4,7,5,16,22,19,4,5,8,17,17,27
Academia,0,0,3,3,1,10,0,0,2,2,1,9
VPS Vaasa,35,29,36,100,132,127,27,31,42,100,92,128
Kehlen,0,0,1,1,1,7,0,0,0,0,0,0
BAK 07,0,0,0,0,0,0,0,0,1,1,1,3
Malahide Utd,0,0,0,0,0,0,0,0,1,1,0,3
Libya,4,5,5,14,18,13,4,6,8,18,21,27
Piast Gliwice,72,32,33,137,202,132,38,41,59,138,161,200
Prescott Cabl.,2,3,3,8,12,11,5,2,5,12,18,20
Widnes,0,0,2,2,3,6,0,0,1,1,0,1
Tiverton,35,17,17,69,140,90,29,12,29,70,124,130
Lyngby,22,23,24,69,80,99,19,10,39,68,77,121
Lleida Esportiu,5,4,5,14,11,13,2,3,6,11,9,17
Brann,41,24,27,92,131,93,35,22,39,96,129,155
Illkirch Graffenstaden,0,0,0,0,0,0,0,1,0,1,3,3
Wealdstone,75,37,56,168,275,252,65,47,57,169,255,247
Jura Sud,1,1,1,3,4,2,0,0,1,1,0,2
Aveley,9,0,5,14,28,20,3,4,5,12,19,21
Bolehall Swifts,1,0,1,2,4,7,1,0,0,1,3,2
Hereford,46,20,20,86,153,94,35,22,23,80,121,100
Lyon,106,36,41,183,374,189,91,42,58,191,338,248
Bokelj,0,1,0,1,1,1,0,1,3,4,1,8
Haughmond,0,0,2,2,2,7,1,0,2,3,5,8
Bunol,0,0,1,1,1,2,1,0,0,1,1,0
Glenavon,65,37,38,140,269,204,63,29,54,146,262,260
Marske Utd,10,1,1,12,36,11,9,0,7,16,33,33
Guatemala,11,5,2,18,32,13,6,4,16,26,20,54
Bedworth Utd,9,5,13,27,42,55,6,4,20,30,32,75
Glasgow United,0,0,1,1,1,2,0,0,0,0,0,0
Kettering,53,25,21,99,195,107,41,19,45,105,189,171
Israel,9,5,12,26,39,35,9,3,15,27,36,47
HJK Helsinki,81,35,15,131,262,107,56,38,32,126,183,129
Alaves,65,50,42,157,184,159,52,29,83,164,166,239
Syria,11,5,1,17,35,13,11,6,13,30,44,44
Juventus,163,28,16,207,439,138,113,38,41,192,314,172
Stoke U23,1,1,4,6,7,11,1,1,4,6,4,8
Weston S-M.,51,26,64,141,221,247,45,26,74,145,203,270
Blaby & W'stone,1,0,0,1,3,1,0,0,1,1,1,8
Super Nova,0,0,1,1,0,6,0,0,0,0,0,0
Newry City,5,3,13,21,18,31,3,2,14,19,19,40
Binfield,2,1,1,4,11,10,3,5,0,8,19,7
Ungheni,0,0,2,2,0,8,0,0,1,1,0,5
Escobedo,1,0,1,2,2,5,0,0,0,0,0,0
Ryhope CW,1,0,0,1,2,1,0,1,1,2,1,4
Iskra-Stali,1,0,0,1,1,0,0,0,0,0,0,0
Stenh'semuir,50,30,77,157,210,282,41,34,78,153,172,267
Sudan,1,2,7,10,4,14,2,0,11,13,10,26
Greece U21,0,1,1,2,1,2,0,0,2,2,0,3
SC Feignies,0,0,0,0,0,0,0,0,1,1,1,2
Viitorul C,67,34,41,142,221,145,48,41,53,142,168,194
Crook Town,0,0,0,0,0,0,0,0,1,1,2,4
Dila,4,0,2,6,10,6,2,1,4,7,7,10
Shepshed D,7,0,1,8,26,10,4,0,5,9,23,26
Wiener Viktoria,0,0,1,1,1,4,0,0,0,0,0,0
Rizespor,39,36,37,112,163,150,25,28,59,112,120,191
Glengad United,0,0,1,1,0,2,0,0,0,0,0,0
Miedz Legnica,7,4,9,20,23,37,3,6,9,18,18,30
Oxford City Nomads,0,0,0,0,0,0,0,0,1,1,2,4
Most,0,0,1,1,1,3,0,0,0,0,0,0
Mali Women,0,0,0,0,0,0,0,0,2,2,2,6
Francs Borains,0,0,1,1,0,3,0,0,0,0,0,0
Leyton Orient,75,43,73,191,276,237,67,49,79,195,231,278
North Korea,8,2,4,14,19,17,7,9,12,28,38,47
Kuressare,0,0,0,0,0,0,0,0,1,1,2,7
Banstead Ath,0,0,1,1,1,3,1,0,2,3,8,6
Am Samoa,1,0,0,1,2,0,1,0,2,3,4,10
Tanzania,9,11,4,24,32,21,1,8,15,24,12,40
Holland FC,0,0,1,1,1,2,0,0,0,0,0,0
Cote Bleue,0,0,1,1,1,2,0,0,1,1,1,6
Etar Veliko Tarnovo,23,21,18,62,76,80,11,15,39,65,53,105
Vyskov,0,0,1,1,1,5,0,0,0,0,0,0
FC Guria Lanchkhuti,1,0,1,2,4,4,0,0,2,2,2,5
Charnock Richard,1,0,2,3,9,12,0,0,3,3,3,8
Alianza,1,1,0,2,2,1,0,0,2,2,2,5
Selkirk,7,3,9,19,34,36,9,0,11,20,42,40
Juve Stabia,5,1,0,6,10,3,2,1,6,9,12,17
Brackley,83,49,38,170,274,172,58,48,55,161,224,190
Thame Utd,8,1,3,12,31,20,3,2,4,9,13,18
River Plate,0,1,1,2,2,5,2,0,0,2,5,0
Sampdoria,73,33,48,154,238,182,37,35,78,150,178,268
FK Skopje,0,1,0,1,1,1,0,0,2,2,1,6
Kruoja,0,2,2,4,2,4,1,0,2,3,5,12
Philadelphia U,55,17,27,99,184,113,24,24,49,97,117,165
O-H Leuven,19,6,18,43,60,57,6,17,20,43,59,87
Goztepe,30,19,21,70,115,94,18,17,35,70,71,99
Victoria Rosport,1,1,2,4,6,12,0,1,3,4,3,11
Bishop's St.,53,32,64,149,207,236,39,25,77,141,182,272
Westfields,6,2,3,11,27,20,4,2,5,11,23,22
Cornella,6,3,4,13,20,15,1,2,4,7,8,18
Wales Women,1,0,0,1,1,0,0,0,0,0,0,0
Mile Oak,0,0,1,1,1,2,0,0,0,0,0,0
Sweden Women,3,0,2,5,8,5,6,1,1,8,11,3
Intercity S J d'Alacant,1,0,1,2,3,3,0,0,0,0,0,0
Tarazona,0,0,1,1,0,1,0,1,1,2,2,5
St Andrew's,3,1,4,8,16,17,3,1,4,8,9,14
Crawley Down,0,1,1,2,3,5,0,1,0,1,3,3
Pro Piacenza,0,0,0,0,0,0,0,0,1,1,1,4
Merstham,46,23,48,117,176,187,34,27,59,120,159,217
Atletico Nacional,0,0,1,1,0,3,0,1,0,1,2,2
Portugal,30,14,7,51,108,34,23,9,7,39,71,36
Kirby Muxloe,0,0,1,1,0,1,0,0,0,0,0,0
Gravesham Borough,0,0,1,1,0,1,0,0,0,0,0,0
Leverstock Gr,1,0,1,2,4,2,2,0,1,3,12,9
Whitehill W,11,4,22,37,57,77,6,4,25,35,36,89
Nancy,19,8,13,40,53,43,13,9,26,48,41,67
Algeciras CF,0,0,0,0,0,0,1,0,1,2,2,2
Lochee Utd,0,1,0,1,1,1,1,0,1,2,4,3
Levski Sofia,76,26,33,135,232,120,52,34,46,132,159,124
Saltash Utd,1,0,3,4,6,13,2,0,1,3,7,6
Long Eaton U,5,1,4,10,18,24,2,1,2,5,10,8
Brackley Town Saints,0,0,1,1,2,4,0,0,0,0,0,0
Gandzasar,5,4,3,12,19,18,1,2,6,9,5,14
Pontevedra,1,1,2,4,2,4,0,0,3,3,0,4
Alemannia Aachen,0,0,1,1,1,4,0,1,0,1,0,0
Ruch Chorzow,23,16,27,66,79,87,19,17,31,67,72,105
Epernay RC,0,0,1,1,0,1,0,0,0,0,0,0
Bradford PA,52,38,60,150,212,232,46,32,70,148,176,252
Opatija,0,0,1,1,0,3,0,0,0,0,0,0
Tenerife,70,63,29,162,204,129,39,49,82,170,170,232
Real Salt Lake,50,27,18,95,153,102,20,16,57,93,108,185
Lyubimets,0,0,8,8,3,22,1,0,6,7,4,28
Wiener Neustadt,8,5,15,28,36,58,4,5,17,26,21,65
SKF Sered,0,0,1,1,0,4,0,0,4,4,3,12
Lowestoft,42,27,38,107,152,147,29,21,54,104,121,196
Ermis,1,0,9,10,7,32,1,3,8,12,13,33
Viktoria Asch.,0,0,0,0,0,0,0,0,1,1,1,2
Olimpic,0,1,0,1,1,1,0,0,0,0,0,0
Aire-Sur-La-Lys,0,0,1,1,1,4,0,0,0,0,0,0
Trans Narva,0,2,4,6,3,11,0,0,8,8,7,27
O. Ljubljana,77,33,36,146,263,144,70,41,31,142,215,136
Jeanfield S,0,0,0,0,0,0,0,0,1,1,1,2
Rosenborg,95,27,23,145,314,147,64,37,41,142,214,166
Harborough T,1,0,1,2,5,7,0,0,1,1,1,5
Castellon,10,1,11,22,22,20,3,8,12,23,17,32
Sunderland RCA,5,0,4,9,17,14,6,1,2,9,25,16
Levadia Maardu,0,0,1,1,0,2,0,0,1,1,0,6
Cremonese,9,7,0,16,31,15,4,3,10,17,12,26
Exmouth Town,5,0,2,7,20,9,1,0,2,3,4,10
Peterhead,78,30,47,155,250,173,65,27,60,152,236,233
Banks o'Dee,3,1,2,6,18,12,4,0,4,8,16,18
Bashley,2,0,15,17,12,48,3,2,9,14,15,36
Bolton,70,54,66,190,229,229,40,40,101,181,173,315
La Fiorita,10,2,9,21,27,32,7,0,8,15,22,32
Gornik Zabrze,43,41,34,118,176,160,32,33,52,117,132,176
AFC Hayes,0,0,2,2,1,4,0,2,0,2,3,3
Harlow,35,11,31,77,139,137,18,16,47,81,89,169
Portmarnock,0,0,1,1,0,2,0,0,0,0,0,0
W. Innsbruck,7,7,10,24,23,30,4,5,15,24,26,42
AFC Eskilstuna,7,11,14,32,38,48,3,6,24,33,22,69
Hadleigh United,0,0,1,1,1,2,0,0,2,2,1,4
Crossgates P,1,0,1,2,4,6,0,0,1,1,1,4
Brisbane Roar,48,21,33,102,158,141,30,27,43,100,135,165
Athlone Town,20,23,57,100,119,202,12,17,71,100,90,244
Debrecen,59,26,29,114,206,124,31,33,51,115,131,163
Hillerod,0,0,1,1,3,5,0,0,0,0,0,0
Recreativo,13,13,12,38,40,43,8,9,21,38,28,54
Laci,6,3,4,13,21,16,2,7,7,16,13,20
P Niedercorn,12,4,6,22,36,21,9,1,13,23,40,41
FK Pohronie,1,0,1,2,3,4,0,0,1,1,1,2
Hajduk Split,82,32,33,147,272,146,62,36,54,152,207,185
Pontarlier,0,1,1,2,2,4,0,0,0,0,0,0
Epinal,3,3,5,11,10,14,4,2,4,10,16,15
Southend U CC,0,0,0,0,0,0,0,0,1,1,2,3
Worthing United,1,0,0,1,3,1,0,0,1,1,0,3
Swaziland,5,2,4,11,10,12,2,3,8,13,10,23
Wurz. Kickers,10,15,18,43,46,65,6,8,23,37,37,68
Portland Utd,0,0,2,2,1,3,1,0,1,2,3,4
Panetolikos,50,26,41,117,146,133,17,36,65,118,79,175
Chile Women,0,2,2,4,2,6,1,0,3,4,2,12
England U21,4,2,6,12,26,18,8,2,3,13,24,13
Metalurg Z.,4,9,18,31,14,57,2,9,20,31,14,69
Thailand,11,7,9,27,37,31,10,3,10,23,26,32
Deportivo Olim,1,2,2,5,7,7,2,1,2,5,5,8
Dunkirk,3,0,0,3,11,4,0,0,4,4,7,14
Kaerjeng,1,0,1,2,2,4,0,0,3,3,5,12
Inter Club D'Escaldes,1,0,1,2,2,2,0,0,1,1,1,2
Afghanistan,5,5,3,13,15,20,1,1,12,14,7,39
Macon,0,1,0,1,0,0,0,0,0,0,0,0
Torpedo Minsk,4,4,22,30,12,51,3,5,22,30,12,53
Lechia Gdansk,67,33,33,133,213,144,42,40,54,136,151,183
Jedinstvo (Ser),0,0,0,0,0,0,0,0,1,1,0,3
Bayreuth,0,0,0,0,0,0,0,0,1,1,1,6
Kimberley M W,0,0,2,2,0,6,1,0,0,1,1,0
FC Volendam,0,1,0,1,1,1,0,0,0,0,0,0
FC Sion,52,37,50,139,210,187,39,31,70,140,167,225
Whitstable,1,2,3,6,10,14,3,0,3,6,8,6
Somalia,1,0,2,3,2,4,0,0,3,3,1,9
Arsenal U21,6,1,1,8,17,8,6,4,7,17,29,34
Brockenhurst,1,1,3,5,6,15,2,0,2,4,12,12
Cobh,40,24,36,100,123,135,31,16,56,103,108,184
Bylis Ballsh,0,0,2,2,1,7,1,1,3,5,3,11
Cumbernauld C,28,12,23,63,108,95,18,16,27,61,91,129
Sibenik,5,4,8,17,12,21,4,4,8,16,20,20
Urk,0,0,1,1,0,4,0,0,0,0,0,0
Dinamo-Auto,2,2,4,8,6,13,0,0,6,6,4,20
Wick Academy,24,17,16,57,122,76,22,11,31,64,110,134
Montecatini,0,0,0,0,0,0,0,0,1,1,0,3
Denmark,23,11,5,39,77,22,12,13,10,35,55,40
Venezia,2,0,0,2,3,0,1,4,2,7,9,10
Koper,33,16,34,83,101,103,28,23,32,83,102,124
Berane,0,0,0,0,0,0,0,0,2,2,2,8
Didcot Town,8,3,5,16,31,26,5,6,6,17,31,28
Murcia,14,5,8,27,41,27,5,8,8,21,17,28
Schweinfurt,4,0,4,8,11,16,0,1,1,2,2,4
Vitre,4,2,1,7,12,7,0,5,1,6,4,6
Haringey B,32,11,15,58,102,71,16,11,24,51,69,80
Paget Rangers,0,0,2,2,1,8,1,0,1,2,2,3
Melton Town,0,0,0,0,0,0,0,0,1,1,2,3
Lyon Duchere,1,1,2,4,4,3,3,2,2,7,10,9
Amstetten,0,0,1,1,0,3,0,0,0,0,0,0
Opava,16,12,21,49,50,64,5,13,33,51,36,105
KF Tirana,2,1,1,4,5,2,1,0,3,4,3,8
Kilmarnock U20,0,0,2,2,1,4,0,0,3,3,4,12
Lushnja,0,0,1,1,2,3,0,0,2,2,2,8
Broughty,1,0,0,1,3,2,0,0,0,0,0,0
Olimpik Donetsk,33,27,43,103,113,156,20,30,54,104,100,174
South Africa Women,0,0,2,2,0,5,0,0,3,3,3,13
E Stadtallendorf,0,0,1,1,0,3,0,0,0,0,0,0
Mickleover S,46,19,49,114,160,163,34,29,56,119,150,191
Sliema W.,2,3,3,8,10,11,1,0,5,6,5,14
Atalanta,89,40,41,170,311,195,66,49,52,167,271,218
Rutherglen G,0,0,0,0,0,0,0,0,1,1,1,4
St Johnstone,66,43,55,164,201,181,69,33,68,170,203,226
Colchester,76,48,67,191,279,239,46,55,86,187,199,300
Velbert,1,0,0,1,2,0,0,0,1,1,1,5
Marine,43,38,58,139,193,207,44,36,60,140,188,210
Weymouth,95,41,41,177,322,202,68,46,63,177,282,258
Babite,0,0,1,1,1,2,0,0,0,0,0,0
Hounslow United,0,0,1,1,1,5,0,0,1,1,1,2
SC Freiburg (Am),1,0,1,2,3,3,0,0,0,0,0,0
Blackburn,85,57,51,193,296,220,60,52,78,190,251,268
Las Rozas,2,0,1,3,7,5,0,0,1,1,0,3
La Chataigneraie,0,0,0,0,0,0,0,1,0,1,1,1
Bemerton H,2,1,1,4,9,7,1,1,1,3,4,4
Reading City,0,0,1,1,0,1,0,0,0,0,0,0
Avro,1,0,1,2,2,3,1,0,0,1,3,2
Partick U20,4,2,0,6,17,8,1,0,2,3,5,6
Vitebsk,36,30,26,92,102,86,28,23,43,94,91,130
Eversley & California,0,0,1,1,0,1,0,0,0,0,0,0
Sligo Rovers,46,41,37,124,163,134,37,25,61,123,130,181
Truro City,72,27,48,147,271,217,61,31,61,153,234,252
Wokingham & Emmbrook,0,0,0,0,0,0,0,0,1,1,1,3
Radford,2,0,3,5,10,13,1,0,0,1,4,0
Newcastle Town,4,4,3,11,26,24,1,0,4,5,4,13
Spain Women,3,1,1,5,10,4,0,2,2,4,2,4
Racing Club Warwick,2,1,2,5,7,7,0,0,0,0,0,0
USA,43,13,15,71,145,63,12,10,12,34,48,46
Forfar,65,27,62,154,233,222,45,36,72,153,192,261
Lietava,1,0,0,1,1,0,0,0,0,0,0,0
Whitchurch Alport,0,0,0,0,0,0,0,0,1,1,0,2
West Auck T,5,1,2,8,12,11,11,1,5,17,29,18
HB Torshavn,7,5,5,17,36,26,5,6,9,20,23,28
Cheshunt,10,2,13,25,31,35,10,2,16,28,44,64
Jagiellonia,68,35,37,140,224,168,53,30,56,139,186,210
Odd Grenland,69,24,21,114,203,120,39,26,49,114,147,177
Zrinjski Mostar,15,5,2,22,41,15,9,6,13,28,25,30
Saarbrucken,12,3,3,18,39,15,10,1,3,14,28,14
Dinamo Batumi,1,3,2,6,1,2,1,1,5,7,4,16
Trastevere,0,0,1,1,1,2,0,0,1,1,0,4
Whyteleafe,1,2,6,9,9,19,3,1,2,6,12,12
Kahramanmarasspor,0,0,1,1,1,3,0,0,0,0,0,0
Estonia U21,0,0,1,1,0,3,0,0,1,1,0,5
Mondorf-les-Bains,0,1,2,3,1,5,1,0,2,3,5,5
Goole,0,1,2,3,4,10,2,0,5,7,10,28
Kidderminster,72,35,51,158,255,184,49,42,66,157,192,220
FK Jurmala,0,0,0,0,0,0,0,0,2,2,1,11
Vila Real,0,0,1,1,0,6,0,0,0,0,0,0
Morpeth Town,15,5,3,23,49,26,12,8,14,34,59,64
Ross County,69,28,63,160,244,225,50,44,71,165,210,263
Sestri Levante,0,0,0,0,0,0,0,0,1,1,0,4
Stockport,86,47,44,177,301,207,71,50,54,175,239,200
Shildon,3,1,3,7,9,9,8,1,5,14,33,27
Broxburn Ath,4,0,3,7,18,13,2,3,2,7,6,10
Sfintul Gheorghe,0,0,2,2,0,4,0,2,1,3,1,6
Kesla FC,1,2,2,5,4,4,0,1,3,4,4,16
Vlla Shkoder,2,1,3,6,3,6,0,0,2,2,4,7
Ukraine Women,0,0,1,1,1,5,0,0,0,0,0,0
Britannia,0,0,0,0,0,0,0,0,1,1,0,10
FSV Frankfurt,5,1,16,22,23,47,6,9,9,24,24,36
Kristiansund,29,19,12,60,116,77,17,18,27,62,73,101
Paulton,19,15,20,54,80,88,13,11,29,53,57,90
G'houghton W,0,0,0,0,0,0,0,0,2,2,2,7
Dundee,58,38,63,159,212,211,44,35,69,148,168,234
Melksham Town,7,2,2,11,23,17,7,2,4,13,29,23
Llosetense,0,0,0,0,0,0,0,0,1,1,0,3
Warrenpoint T,27,24,67,118,151,246,24,24,69,117,128,249
F Dusseldorf II,1,0,0,1,3,0,1,0,0,1,1,0
Chesterfield,65,41,75,181,258,255,57,45,90,192,213,285
Sivasspor,48,39,29,116,156,119,31,31,54,116,159,209
FC Liege,1,0,0,1,3,0,0,0,0,0,0,0
Dundalk,95,32,22,149,316,116,87,28,35,150,278,143
Llagostera,22,11,15,48,64,41,8,12,27,47,33,68
Basel,106,39,24,169,367,171,95,33,48,176,326,223
Brigg Town,0,1,0,1,0,0,0,0,2,2,6,11
Sputnik,0,0,5,5,4,17,1,1,4,6,5,13
Welwyn Gard C,5,1,4,10,21,21,2,1,2,5,8,6
Kapaz,1,2,4,7,4,9,1,0,6,7,2,10
Rio Ave,53,44,39,136,175,149,42,37,59,138,145,189
Oedt,0,0,1,1,0,6,0,0,0,0,0,0
Gostivar,0,0,1,1,0,3,0,0,0,0,0,0
Wales,20,8,5,33,46,23,11,7,13,31,30,31
Trakia Plovdiv,0,0,0,0,0,0,0,1,0,1,1,1
Den Haag,41,37,45,123,176,193,29,30,65,124,134,242
Huddersfield,59,44,76,179,205,236,42,42,94,178,182,324
Ivybridge Town,0,1,1,2,1,3,1,0,1,2,6,4
Ajaccio,8,10,14,32,38,45,7,5,25,37,29,64
Witton,50,22,35,107,181,160,33,25,47,105,134,155
Buckingham Ath,0,1,0,1,3,3,0,0,3,3,5,13
Seligenporten,0,1,0,1,1,1,0,0,0,0,0,0
Breidablik,2,2,6,10,12,16,0,4,2,6,9,12
Macarthur FC,3,4,3,10,15,14,6,1,4,11,11,14
Bottesford Town,2,1,2,5,13,9,1,1,2,4,10,10
FC Elmstead,0,0,1,1,0,2,0,0,0,0,0,0
Malawi,8,2,5,15,15,12,4,7,11,22,9,23
Cibalia,7,12,17,36,35,58,3,5,28,36,27,96
Beauvais,1,1,1,3,4,3,4,1,1,6,15,9
Bournem'th FC,1,0,2,3,7,5,0,0,2,2,3,6
Lordswood,1,0,4,5,6,10,4,0,1,5,10,7
Boreham W,71,55,57,183,250,211,63,53,63,179,240,208
Club Colonial,0,0,0,0,0,0,0,0,1,1,1,3
N Ireland,16,5,11,32,43,30,9,11,16,36,27,41
Birkirkara,10,3,5,18,24,14,9,4,4,17,37,20
Mt de Marsan Stade,0,0,0,0,0,0,0,0,1,1,0,1
Panazol,0,0,1,1,0,3,0,0,0,0,0,0
Hungary Women,0,0,0,0,0,0,0,0,1,1,1,5
New England,48,26,19,93,149,95,18,28,53,99,119,204
Chorrillo,0,1,0,1,1,1,0,0,2,2,0,4
B93 Copenhagen,0,0,1,1,0,3,0,0,0,0,0,0
Rouen,1,0,1,2,4,4,0,0,0,0,0,0
Hradec Kralove,8,5,17,30,25,43,6,5,19,30,30,60
Roeselare,1,0,4,5,10,14,1,1,3,5,7,8
E. Ettelbruck,0,0,3,3,1,10,0,0,5,5,4,17
Lucerne,57,37,47,141,235,195,47,24,69,140,181,238
BFC Preussen,0,0,1,1,0,7,0,0,0,0,0,0
Ibiza Islas Pitiusas,0,0,1,1,0,2,0,0,0,0,0,0
Bolivia,7,3,9,19,29,37,3,8,32,43,26,102
Jagodina,11,13,17,41,46,56,9,11,22,42,41,68
Toledo,3,0,2,5,13,8,0,1,2,3,2,5
Turkey U21,0,1,0,1,1,1,0,0,2,2,0,2
Merthyr,55,32,29,116,223,145,32,33,50,115,155,192
Grasshoppers,41,19,44,104,148,145,23,32,50,105,142,196
Wil,1,0,0,1,2,0,0,0,0,0,0,0
Alma Juventus Fano,0,0,1,1,0,1,0,0,1,1,1,5
Bradford Town,9,0,5,14,43,32,7,1,2,10,19,13
Saint-Priest,0,0,0,0,0,0,0,0,2,2,1,7
Olimpic Sarajevo,0,2,3,5,4,10,0,1,0,1,0,0
Australia Women,2,0,1,3,7,4,1,1,3,5,9,13
Squires Gate,1,0,0,1,2,1,0,0,1,1,1,2
Peacehaven & T,8,5,14,27,38,54,7,5,15,27,31,54
Louhans-Cuiseaux,0,0,1,1,0,2,0,0,0,0,0,0
Millwall,87,62,58,207,275,234,63,52,76,191,225,262
Benin,8,5,0,13,18,8,4,8,10,22,20,39
Ap Limassol,39,16,10,65,146,67,23,10,25,58,82,88
Albalonga,0,0,0,0,0,0,0,0,1,1,1,2
Lens,23,20,23,66,73,79,23,15,33,71,90,113
Beroe Stara,63,35,28,126,192,109,53,29,47,129,151,150
Luneburger,0,0,1,1,1,3,0,0,0,0,0,0
Vendee Les Herbiers,8,6,7,21,24,22,7,7,6,20,27,24
FC Slutsk,35,28,42,105,102,119,29,22,59,110,97,163
Newi CD,29,21,43,93,121,170,24,23,45,92,102,165
Queen of Sth,70,34,58,162,265,212,49,40,68,157,213,236
Guinea-Bissau,5,1,4,10,13,16,2,5,7,14,9,23
Livingston U20,0,1,1,2,1,3,0,0,1,1,1,4
East Kilbride,49,12,21,82,190,88,44,17,15,76,146,76
Pardubice,7,6,3,16,24,19,6,1,9,16,14,24
Tottenham U23,0,0,1,1,0,2,2,0,1,3,6,3
Germany Women,4,1,1,6,10,4,2,0,1,3,6,3
Grays,31,21,38,90,117,133,31,14,47,92,124,177
AFC Portchester,1,0,3,4,5,7,2,0,1,3,5,4
Cinderford,10,6,14,30,49,49,3,2,27,32,27,91
Heather St J,0,0,0,0,0,0,1,0,3,4,6,9
Ironi Kiryat S,54,31,46,131,163,134,38,37,56,131,144,176
Deeping R,4,0,2,6,13,8,4,0,2,6,13,11
FAIRM I-R M,0,1,1,2,0,2,1,0,0,1,2,0
S-W Rehden,0,1,0,1,1,1,0,0,0,0,0,0
Godmanchester,2,2,2,6,7,8,3,0,3,6,11,14
Gotene,0,0,1,1,0,5,0,0,0,0,0,0
Astoria Walldorf,3,3,2,8,11,11,2,0,3,5,11,9
Mariupol,28,21,31,80,103,113,20,21,43,84,76,141
Cheadle Town,0,0,1,1,0,2,0,0,1,1,1,5
Glenville,0,0,0,0,0,0,0,0,1,1,0,1
Cumnock,0,1,0,1,2,2,0,0,1,1,3,4
FC Yerevan,0,0,1,1,1,2,0,0,0,0,0,0
Montagnarde,1,1,2,4,3,4,1,1,1,3,7,6
Lommel,0,0,0,0,0,0,0,0,2,2,1,6
Modena,2,4,3,9,10,10,1,2,4,7,9,11
Eastbourne T,5,0,5,10,28,21,5,0,3,8,24,20
Benfica (B),0,0,0,0,0,0,1,0,0,1,2,0
Crawley,75,44,72,191,244,249,41,45,104,190,201,332
Shoreham,0,0,2,2,3,5,0,0,1,1,1,7
Lauda,0,0,1,1,0,7,0,0,0,0,0,0
France Women,8,0,1,9,22,6,0,0,0,0,0,0
Melilla,2,0,3,5,6,7,1,0,3,4,4,10
AE Prat,0,0,0,0,0,0,0,0,1,1,0,1
Harpenden T,0,0,0,0,0,0,0,0,2,2,0,8
New York City,55,24,19,98,196,116,35,23,41,99,138,153
Altach,51,30,44,125,179,159,35,29,63,127,134,202
Ilkeston,28,20,36,84,104,123,27,14,44,85,116,153
Santa Tecla FC,1,0,0,1,2,1,0,0,1,1,0,4
AFC Dunstable,4,0,4,8,17,14,2,0,3,5,7,10
Burton Park Wanderers,0,0,0,0,0,0,0,1,0,1,2,2
Warrington,65,23,25,113,178,106,44,32,30,106,165,143
Badshot Lea,0,0,1,1,0,7,2,0,1,3,6,3
Panthrakikos K,17,10,14,41,47,48,3,10,27,40,23,79
Harefield United,0,0,2,2,0,5,0,0,1,1,1,3
Daventry Town,0,1,2,3,3,6,0,0,3,3,2,7
Penicuik Athletic,2,0,2,4,9,7,4,0,1,5,14,4
APV Strasbourg,0,0,0,0,0,0,0,1,1,2,2,3
Granville,0,0,0,0,0,0,0,1,0,1,2,2
Quimperle,0,0,1,1,1,2,0,0,0,0,0,0
TSV Havelse,0,0,1,1,1,5,0,0,0,0,0,0
Baldock Town,1,0,0,1,3,0,0,0,6,6,7,20
Kidsgrove Ath,5,0,6,11,16,16,6,4,1,11,26,18
Feyenoord,97,25,26,148,330,146,60,38,48,146,239,197
Italy U21,5,4,6,15,19,13,4,3,3,10,15,13
NY Red Bulls,63,17,20,100,179,87,33,26,48,107,149,170
Honduras,17,9,13,39,53,38,6,14,21,41,35,73
Halifax,83,56,53,192,295,233,60,50,68,178,212,228
USV Eschen-M,0,0,1,1,1,5,0,0,0,0,0,0
Winterton R,2,0,1,3,5,6,0,0,2,2,0,7
Mildenhall Town,2,0,2,4,8,10,4,1,3,8,13,7
AE Zakakiou,0,0,1,1,1,4,0,0,1,1,0,7
Vejle BK,11,9,10,30,47,43,4,10,17,31,24,54
PSV II,0,0,0,0,0,0,0,0,1,1,1,2
Mickleover Royals,2,0,0,2,5,0,0,0,0,0,0,0
Litherland R,0,0,2,2,2,8,0,0,1,1,1,3
Mallorca,68,37,38,143,185,126,28,44,72,144,132,207
Juventus U23,0,0,0,0,0,0,0,0,1,1,0,1
Lombard-Papa,5,7,9,21,15,31,1,4,17,22,10,52
FC Speranta Crihana Veche,0,0,0,0,0,0,0,0,1,1,0,2
Irchester United,0,0,1,1,0,4,1,0,1,2,3,4
M-BSI Jajce,0,1,0,1,0,0,0,0,0,0,0,0
Racing Murcia,0,0,1,1,0,5,1,0,0,1,3,0
Barking,4,2,2,8,10,7,1,1,5,7,6,19
Pisa,6,1,2,9,20,8,2,4,6,12,14,23
Worgl,0,0,0,0,0,0,0,0,1,1,0,3
Faversham,1,0,5,6,9,13,2,0,3,5,8,8
Sundsvall,20,21,36,77,94,118,19,20,37,76,88,129
Othellos Athienou,0,0,1,1,1,2,0,0,0,0,0,0
Praiense,0,0,0,0,0,0,0,0,1,1,1,5
IK Sirius,19,16,28,63,96,121,20,16,29,65,80,104
Jonkopings Sodra,10,13,8,31,34,31,5,11,16,32,33,61
Afan Lido,0,1,7,8,6,40,0,1,4,5,1,20
PFC Septemvri Sofia,12,6,16,34,32,50,9,5,19,33,34,63
L'Aquila,2,0,0,2,5,1,1,0,2,3,3,9
Saburtalo,2,2,4,8,7,12,5,1,4,10,13,15
Loko. Plovdiv,56,33,37,126,173,143,40,26,62,128,131,188
Godalming,0,0,0,0,0,0,0,0,3,3,3,10
Glenafton Ath,1,0,0,1,4,0,2,0,1,3,3,2
Academico Viseu,0,1,0,1,1,1,0,0,1,1,0,3
Waltham Abbey,2,0,3,5,5,13,2,0,3,5,9,13
Iraklis Salonika,7,15,8,30,29,28,7,7,16,30,23,43
San Marino U21,0,0,2,2,0,7,0,0,1,1,0,5
NAC Breda,15,16,28,59,71,103,7,16,37,60,49,119
Teuta,5,0,5,10,12,14,1,1,5,7,8,20
Derby,94,54,47,195,300,188,67,53,78,198,244,274
H. Haifa,41,41,50,132,156,179,36,37,54,127,133,175
Angrense,0,0,1,1,0,2,0,0,0,0,0,0
Toulouse,49,39,46,134,186,173,27,33,82,142,125,235
KV Reykjavik,0,0,1,1,1,7,0,0,0,0,0,0
Bari,9,0,3,12,20,11,2,3,4,9,8,10
Biggleswade T,53,28,33,114,214,171,27,27,55,109,135,174
IR Reykjavik,0,1,0,1,1,1,0,0,0,0,0,0
Street,1,0,2,3,4,4,1,3,1,5,10,15
Cricklewood Wanderers,1,0,0,1,1,0,0,0,3,3,1,12
Villefranche,2,2,3,7,8,10,1,2,1,4,5,3
Cayman Islands,0,1,1,2,1,12,0,1,2,3,0,7
Arundel,0,0,1,1,0,2,0,0,0,0,0,0
NK Zavrc,14,12,18,44,40,48,15,7,22,44,54,77
Western Sydney,38,30,34,102,152,144,26,28,48,102,143,178
Newtongrange S,0,0,1,1,0,5,0,0,2,2,2,7
Aruba,2,0,2,4,5,10,0,0,3,3,0,8
Airbus UK,26,12,30,68,110,126,17,17,40,74,90,140
Shamkir,0,0,0,0,0,0,0,0,1,1,0,2
Sutton Utd,89,51,39,179,289,191,72,49,62,183,238,222
Colorado,41,22,28,91,136,126,18,24,52,94,86,152
Namibia,6,2,6,14,15,14,3,3,7,13,9,17
Longlevens,1,0,1,2,3,5,0,1,3,4,5,10
Scarborough A,18,14,10,42,69,50,17,4,27,48,59,83
NK Aluminij,34,21,33,88,121,114,22,23,44,89,92,142
Brentwood T,12,12,15,39,63,54,6,7,21,34,41,78
H. Kopavogs,0,0,1,1,1,2,0,0,0,0,0,0
FK Montana,0,0,1,1,0,4,0,0,0,0,0,0
Zabudova-2007,0,0,2,2,0,15,0,0,0,0,0,0
Sheppey United,2,0,3,5,8,10,2,1,1,4,8,7
Cuneo,0,0,0,0,0,0,0,0,1,1,0,1
M'well U20,7,0,2,9,19,8,3,0,4,7,12,13
Kosovo,14,4,11,29,41,44,3,6,11,20,23,31
Sportfreunde D,0,0,1,1,0,5,0,0,0,0,0,0
Bedford,9,1,12,22,37,41,7,7,10,24,35,42
Azal,0,1,5,6,1,13,0,0,7,7,2,15
Vozdovac,63,27,38,128,179,129,32,29,69,130,118,200
Eswatini,0,1,1,2,2,4,0,0,1,1,1,4
Lorient,43,27,38,108,145,134,28,21,62,111,129,192
Sutton Athletic,0,0,1,1,0,2,0,0,0,0,0,0
Volyn,11,13,23,47,53,62,13,8,27,48,44,94
Czech Rep. U21,5,2,2,9,19,12,3,1,5,9,13,16
Doxa,0,2,3,5,3,9,0,3,6,9,3,19
Pordenone,10,5,3,18,38,23,5,7,4,16,14,16
Hanley Town,1,0,1,2,3,4,0,0,5,5,2,12
Dukla Bystrica,0,1,3,4,3,6,0,0,4,4,2,11
Sweden,26,11,11,48,78,36,14,9,17,40,53,46
Rossington Main,0,0,1,1,4,6,0,0,0,0,0,0
SC Paderborn,39,29,37,105,175,173,29,24,50,103,129,166
Real Titanico,0,0,1,1,0,2,0,0,0,0,0,0
Helsingor,6,1,9,16,12,21,2,2,12,16,16,40
Maubeuge,0,0,0,0,0,0,0,0,1,1,1,3
West Essex,0,0,1,1,1,2,0,0,0,0,0,0
Frenford,0,0,1,1,1,3,1,0,0,1,4,2
Slovakia U21,4,0,1,5,13,4,2,1,1,4,7,6
NK Celje,54,39,42,135,190,166,51,36,48,135,170,164
Akragas,0,0,0,0,0,0,0,0,1,1,0,2
Highworth,4,3,6,13,17,23,4,2,2,8,16,12
Moreirense,35,42,41,118,133,151,37,24,59,120,118,177
RSV Meinerzhagen,0,0,1,1,1,6,0,0,0,0,0,0
Slaven,51,41,40,132,171,146,16,41,77,134,109,228
Jeunesse Esch,6,3,6,15,21,19,5,1,6,12,21,22
Kerkyra,19,13,15,47,50,47,5,13,29,47,30,85
Swansea U23,5,1,1,7,10,4,3,1,3,7,10,12
Mechelen,55,26,33,114,183,143,32,27,53,112,129,194
Lugano,41,35,39,115,142,148,33,34,49,116,153,199
Irtysh,2,4,3,9,7,8,4,3,7,14,17,25
Skala,1,0,5,6,4,12,0,1,3,4,1,11
Crystal Palace,56,31,70,157,179,198,55,36,69,160,194,239
Hammarby,48,29,20,97,192,117,32,24,37,93,131,146
San Nicolo,0,0,0,0,0,0,1,1,0,2,3,2
May and Baker Eastbrook C,1,0,1,2,6,3,1,0,1,2,5,2
Limonest,2,2,1,5,6,4,1,2,1,4,2,2
Keynsham Town,0,0,1,1,0,4,0,0,0,0,0,0
Monterosi,0,0,0,0,0,0,0,0,1,1,0,1
Australia,17,4,9,30,69,35,13,13,12,38,56,40
Fiorentino,0,0,0,0,0,0,0,0,1,1,0,4
Lyon Duchere II,0,1,0,1,0,0,0,0,0,0,0,0
Felixstowe & W,4,0,1,5,14,4,1,0,6,7,4,21
Alajuelense,1,1,1,3,2,2,0,1,1,2,1,2
Deveronvale,20,6,36,62,94,123,21,5,24,50,91,111
Yorkshire Am,0,0,0,0,0,0,0,0,1,1,1,3
Austria,21,10,10,41,59,42,16,4,7,27,46,26
Elazigspor,3,3,2,8,8,5,3,0,6,9,11,18
Ordabasy,6,5,7,18,22,23,4,3,7,14,16,23
Oskarshamns AIK ,1,0,1,2,3,5,0,0,1,1,1,3
Noisy Le Grand,3,0,0,3,5,2,0,0,1,1,1,2
Tuttocuoio,0,0,0,0,0,0,1,0,2,3,3,6
Inter,103,43,31,177,333,156,77,43,52,172,259,196
Charleroi,71,40,35,146,220,143,50,36,58,144,196,208
Udinese,61,34,62,157,213,208,33,35,78,146,150,243
Sydney FC,60,22,22,104,186,104,52,28,21,101,185,105
Holland Women,9,0,0,9,25,4,3,1,0,4,6,2
Zaragoza II,1,0,0,1,2,1,0,0,0,0,0,0
Alcorcon,67,50,49,166,176,141,42,51,72,165,146,213
Sp. Rotterdam,25,12,27,64,106,105,12,15,37,64,60,126
Hartlepool,72,38,71,181,228,226,46,49,88,183,206,291
Aurillac,0,0,0,0,0,0,0,0,2,2,3,7
Lege-Cap-Ferret,0,0,0,0,0,0,0,1,1,2,3,4
Saint-Louis N,0,1,2,3,3,7,0,4,2,6,5,11
Rangers,142,30,27,199,460,147,107,46,40,193,362,197
Tuzlaspor,0,0,0,0,0,0,1,0,0,1,2,0
Braga,104,31,28,163,319,158,67,36,59,162,226,198
Wellington,42,22,39,103,162,151,27,20,53,100,139,196
Isloch Minsk,32,20,29,81,97,97,27,17,35,79,86,122
US Sinnamary,0,1,0,1,1,1,0,0,0,0,0,0
Slavia Mozyr,27,19,34,80,107,125,17,20,41,78,75,128
Kirkley & P,0,0,2,2,3,5,5,0,2,7,17,11
Merida AD,0,3,2,5,6,12,0,0,1,1,0,2
Trepca 89,2,0,3,5,15,15,2,0,2,4,6,3
Killester U,0,1,0,1,3,3,0,0,0,0,0,0
Pafos,1,1,0,2,4,2,0,0,2,2,0,4
Russia,24,12,13,49,90,53,12,8,13,33,55,45
Besiktas,109,36,20,165,354,150,80,34,48,162,267,214
Lealtad,0,0,2,2,1,3,1,0,1,2,3,3
Wednesfield,0,0,0,0,0,0,0,0,2,2,1,9
VCD Athletic,15,14,26,55,68,98,10,8,30,48,42,96
Newbury Forest,0,0,2,2,2,7,0,0,0,0,0,0
Tunisia U21,0,0,0,0,0,0,0,0,1,1,0,2
Derby U21,3,0,3,6,6,8,1,1,2,4,7,8
Chania,0,0,1,1,0,4,0,0,0,0,0,0
Whitley Bay,1,0,3,4,7,8,3,2,1,6,20,13
Kardemir,23,14,25,62,64,80,5,11,44,60,53,137
Milton Keynes Irish,1,0,0,1,2,0,0,2,0,2,5,5
Ramsgate,1,1,4,6,8,16,1,1,4,6,5,19
Exeter U21,0,0,0,0,0,0,0,0,1,1,1,2
Karlsruhe,20,27,28,75,88,101,21,21,34,76,80,115
Gillingham Town,0,1,1,2,0,1,1,0,1,2,4,4
Croatia U21,7,2,1,10,27,10,3,3,6,12,21,21
Hadley,2,2,2,6,8,7,1,0,0,1,3,1
Le Mans,5,1,5,11,20,22,4,2,3,9,14,13
Vikingur (Ice),1,0,3,4,2,9,1,3,4,8,9,14
Fulham U23,2,0,1,3,4,2,1,0,2,3,3,4
JS Saint-Pierroise,0,0,0,0,0,0,1,0,1,2,2,2
Romania U21,4,2,0,6,16,5,3,2,2,7,10,9
Comunicaciones,0,2,0,2,2,2,1,1,1,3,3,3
Steyning Town,4,0,1,5,14,7,0,0,2,2,3,6
Alcoyano,7,3,2,12,19,11,3,2,3,8,5,7
Sochaux,19,12,9,40,50,32,13,11,16,40,43,51
ESM Gonfreville,0,0,2,2,0,4,0,1,0,1,1,1
Swanage T,0,0,0,0,0,0,0,0,1,1,1,2
FC Nitra,1,1,0,2,3,0,1,1,1,3,4,4
Bradford,85,53,62,200,255,225,60,57,79,196,217,260
Carshalton,41,10,21,72,130,97,20,13,28,61,79,102
Rocester,1,0,2,3,11,9,0,0,2,2,4,10
Civil Serv Strol,23,9,17,49,79,67,21,12,25,58,86,106
Mtsapere,0,0,0,0,0,0,0,0,1,1,0,2
Oberhausen,0,0,1,1,0,6,0,0,0,0,0,0
Shawbury Utd,0,1,0,1,0,0,0,0,2,2,1,6
Maine Road,1,0,0,1,6,2,0,0,2,2,2,5
Westfield,2,1,2,5,6,9,4,1,3,8,18,12
Mainz,55,32,47,134,196,172,37,33,70,140,172,259
West Brom U21,1,1,6,8,6,15,2,1,13,16,15,42
Totton & Eling,0,0,0,0,0,0,0,0,1,1,0,2
Flamengo,1,0,0,1,3,1,0,0,1,1,0,1
Manisaspor,0,0,0,0,0,0,0,0,1,1,0,9
Durango,0,0,0,0,0,0,1,0,2,3,5,4
Zamudio,0,0,0,0,0,0,0,0,1,1,0,4
Bad Gleichenberg,0,0,1,1,0,3,0,0,0,0,0,0
Rende,0,0,0,0,0,0,0,0,4,4,1,7
Dainava,1,0,0,1,2,0,0,0,2,2,1,21
Falkirk,78,41,36,155,260,152,62,43,59,164,218,220
Arsenal U23,1,0,2,3,3,7,1,0,0,1,3,1
Duisburg,18,14,32,64,80,117,15,17,26,58,63,94
Hannover,54,24,52,130,178,178,34,33,70,137,177,244
Ormiston,0,0,0,0,0,0,0,0,1,1,1,2
Redditch,49,31,27,107,190,130,39,21,47,107,149,149
Sri Lanka,1,0,4,5,3,7,0,0,5,5,1,15
Mauritania,6,3,2,11,15,7,5,3,13,21,17,40
Lecce,14,6,10,30,55,44,7,5,21,33,36,79
Empoli,42,26,32,100,143,125,15,26,49,90,89,155
Flora Paide,1,0,6,7,6,20,0,1,3,4,2,8
Germania E/L,0,0,1,1,0,6,0,0,0,0,0,0
Viborg,8,14,18,40,37,59,13,6,21,40,45,56
Athersley Rec,0,0,1,1,1,5,0,0,0,0,0,0
Bulgaria,12,6,13,31,36,41,5,7,16,28,19,51
Edusport Acad,16,12,25,53,101,105,19,6,27,52,80,94
Rodez,2,1,3,6,2,5,0,2,3,5,4,8
South Shields,43,9,9,61,161,65,31,10,13,54,93,62
Mutilvera,1,0,2,3,3,6,0,1,0,1,1,1
Alanyaspor,46,17,25,88,168,106,23,19,47,89,99,143
Venezuela,6,7,9,22,25,28,12,13,19,44,49,68
Bala Town,66,24,31,121,237,152,57,24,42,123,205,183
HOB Hawthorn,0,0,0,0,0,0,1,0,2,3,5,7
Adanaspor,4,3,10,17,20,32,2,4,11,17,13,30
Camberley T,2,0,1,3,9,5,3,1,3,7,9,11
Carlton Town,5,1,3,9,15,16,2,1,4,7,9,11
French Guiana,4,0,1,5,11,5,2,1,3,6,8,13
Wolverhampton SC,2,1,2,5,14,10,2,0,1,3,6,7
Middlesbrough,93,45,55,193,253,168,64,52,70,186,215,221
Bovey Tracey,1,0,0,1,3,1,0,0,1,1,2,7
Thame Rangers,1,0,0,1,4,2,0,0,1,1,2,3
Estrela,0,0,1,1,0,4,0,0,0,0,0,0
Niki Volos,1,2,13,16,2,37,0,0,17,17,3,47
Syrianska,1,0,0,1,5,1,0,0,2,2,1,14
NK Karlovac,0,0,1,1,0,7,0,0,0,0,0,0
Zaglebie Sos,6,3,9,18,34,42,1,5,13,19,15,38
Ribadumia,0,0,1,1,0,2,1,0,0,1,1,0
Fermana,0,1,0,1,0,0,0,1,1,2,4,5
Leca,0,0,1,1,1,3,0,0,0,0,0,0
Brest II,1,0,0,1,3,1,0,0,0,0,0,0
Din. Moscow,37,32,29,98,123,94,36,30,40,106,119,140
Alresford Town,3,0,1,4,10,6,0,0,3,3,2,7
Arminia,43,32,35,110,152,139,29,46,34,109,148,157
Iceland Women,0,0,0,0,0,0,1,1,0,2,4,3
Sp. Siegen,0,1,0,1,3,3,0,0,0,0,0,0
Celik Zenica,3,3,2,8,8,8,0,2,4,6,4,15
Malmesbury Victoria,0,0,1,1,3,5,1,0,2,3,6,10
Dulwich H,84,35,45,164,318,209,67,49,56,172,252,210
Welton Rovers,3,0,1,4,8,3,0,1,2,3,2,8
Villarreal B,1,1,0,2,3,2,0,1,1,2,0,2
Gjilani,0,0,1,1,0,2,1,0,1,2,5,6
Wolverhampton C,1,0,1,2,3,3,1,0,0,1,2,0
Ireland,16,14,10,40,53,35,7,14,13,34,29,40
Ternana,4,3,4,11,14,9,1,1,6,8,5,19
Greece,13,8,13,34,36,36,11,13,13,37,33,38
Huntingdon T,0,0,1,1,2,4,1,0,1,2,5,3
H. Kfar Saba,16,15,34,65,47,73,16,20,31,67,53,92
Chelmsford,73,37,41,151,281,199,56,33,68,157,222,243
Hapoel Hadera,18,14,20,52,64,68,17,12,22,51,52,68
Witheridge,0,0,1,1,0,1,0,0,0,0,0,0
Knaphill,2,0,1,3,10,6,3,0,3,6,10,11
FC Daugava,1,2,0,3,4,3,2,1,1,4,5,2
Ethiopia,3,5,7,15,18,22,2,2,9,13,11,32
Montanesa,0,0,1,1,0,1,0,0,0,0,0,0
Rubin,46,32,38,116,126,110,33,40,44,117,119,141
UNA Strassen,1,0,1,2,2,3,0,1,1,2,3,7
Pistoiese,0,0,0,0,0,0,0,0,1,1,0,1
Rennes,72,48,49,169,232,201,57,46,64,167,205,222
Stratford,28,23,27,78,117,105,20,19,39,78,96,141
B-Uhlenhorst,0,0,1,1,0,5,0,0,0,0,0,0
Mozambique,6,5,4,15,18,16,4,5,9,18,16,29
China Women,1,2,1,4,3,4,1,0,3,4,2,5
Saint-Brice,0,0,1,1,0,1,0,0,0,0,0,0
Pineto,0,0,0,0,0,0,0,0,1,1,0,1
Montenegro,12,8,12,32,42,35,7,7,14,28,26,42
Stourport,4,0,2,6,14,11,2,0,1,3,8,5
Samtredia,4,1,5,10,12,13,1,0,5,6,5,17
Coria,0,0,1,1,2,3,0,0,0,0,0,0
Greenhouse Sports,0,0,0,0,0,0,1,0,1,2,4,3
Aalborg,59,30,45,134,182,146,40,38,53,131,159,193
SC Hazebrouck,0,0,1,1,0,2,0,0,0,0,0,0
Floresti,0,0,1,1,0,1,0,0,0,0,0,0
West Ham U21,3,2,7,12,15,25,13,1,13,27,41,50
FC Vac,0,0,1,1,1,3,0,0,0,0,0,0
B. Munich II,0,1,1,2,2,4,0,0,0,0,0,0
Yenisey,0,0,1,1,1,2,0,0,1,1,1,4
Liberia,5,3,2,10,15,8,3,0,9,12,6,19
Ostersunds FK,38,18,29,85,129,104,26,27,34,87,102,130
Valerenga,51,31,24,106,184,118,29,29,48,106,143,185
Dartford,75,42,45,162,278,194,63,37,57,157,210,221
Nantwich,76,35,47,158,275,209,56,40,60,156,244,251
LASK Linz,45,16,20,81,161,91,44,12,24,80,132,89
Biggleswade United,3,3,3,9,20,17,1,1,1,3,4,6
Eynesbury Rovers,0,0,1,1,3,4,3,0,3,6,17,14
Coventry,89,55,50,194,267,203,55,52,89,196,213,283
Coggeshall United,1,0,1,2,1,2,0,0,1,1,2,4
Rugby,1,0,4,5,4,7,1,3,4,8,11,17
Tajikistan,6,0,6,12,19,15,3,3,8,14,17,32
Neuc. Xamax,7,10,19,36,41,60,7,12,17,36,36,74
Holker Old Boys,0,0,2,2,1,3,1,0,1,2,2,4
Gimnastica Segoviana,0,1,1,2,1,2,0,0,0,0,0,0
Plymouth,97,39,62,198,316,258,66,46,82,194,215,258
Droylsden,2,3,12,17,24,55,4,4,11,19,25,56
Chaves,18,21,15,54,70,65,13,11,29,53,51,93
Bosnia-Hz.,14,9,8,31,54,30,13,9,16,38,46,51
Israel U21,0,1,0,1,0,0,0,0,0,0,0,0
Pontefract C,2,1,1,4,9,8,0,0,4,4,10,17
Spartak Moscow,66,28,32,126,201,135,54,24,44,122,162,165
Rot-Weiss Erfurt,0,0,2,2,1,4,1,0,0,1,1,0
Chertsey Town,5,1,2,8,22,6,5,1,2,8,19,9
Gambia,1,5,2,8,6,9,3,2,4,9,7,12
Sirens FC,0,0,0,0,0,0,0,0,1,1,1,2
Carlisle,78,51,65,194,289,271,61,56,81,198,248,296
Scotland U21,0,0,2,2,0,3,0,0,2,2,0,6
All Dudelange,1,0,0,1,4,0,0,0,0,0,0,0
North Leigh,2,0,4,6,8,13,7,4,5,16,38,35
S Normanton A,2,0,1,3,5,4,1,0,1,2,3,2
Giresunspor,0,0,0,0,0,0,0,0,1,1,0,1
Sp Gijon II,0,0,0,0,0,0,0,1,0,1,0,0
Maynooth Uni,0,0,0,0,0,0,0,0,1,1,0,4
MK Dons,86,39,78,203,291,259,63,51,79,193,252,272
Auxerre AJ II,0,1,0,1,2,2,1,0,1,2,2,4
M'Boro U21,3,0,1,4,10,4,3,0,0,3,7,3
Bassano V,2,2,0,4,7,4,2,1,4,7,8,19
AFC Rush & D,2,3,4,9,10,18,2,0,3,5,8,9
Tvaakers IF,1,0,1,2,3,4,0,0,1,1,1,2
Basaksehir,77,41,22,140,250,134,57,41,44,142,177,171
Racing,12,15,21,48,53,60,11,14,27,52,46,72
Brentford,101,46,46,193,338,201,68,44,75,187,266,261
Costa Rica,17,15,8,40,51,29,17,11,25,53,58,80
Rezzato,0,0,0,0,0,0,1,0,1,2,3,6
O. Marcquois,0,0,2,2,4,9,0,0,0,0,0,0
Kapfenberg,0,0,1,1,1,2,0,0,0,0,0,0
US Esch,0,0,1,1,0,3,0,0,0,0,0,0
Ravan Baku,0,0,1,1,0,3,0,0,0,0,0,0
Alki Oroklini,0,0,3,3,1,8,0,0,1,1,0,3
Al Jazira,1,0,2,3,3,6,0,0,0,0,0,0
SV Lippstadt,0,0,0,0,0,0,0,0,1,1,0,1
Hamburg,56,33,46,135,183,175,37,35,66,138,166,235
Heerenveen,48,43,38,129,195,177,38,31,58,127,197,241
Albania U21,0,0,1,1,0,1,0,0,0,0,0,0
Kamza,0,1,1,2,2,3,0,0,0,0,0,0
Sevenoaks T,1,1,1,3,6,7,2,1,3,6,10,12
FC Copenhagen,112,32,25,169,348,159,78,42,52,172,238,183
Balikesirspor,4,4,9,17,25,31,2,5,10,17,23,38
Hyeres,0,1,0,1,0,0,0,0,0,0,0,0
Italy,26,16,5,47,86,25,20,5,8,33,55,31
Luton,106,48,51,205,372,224,76,47,70,193,235,233
Novara,9,2,4,15,30,16,1,5,8,14,16,30
Ampthill Town,1,1,1,3,5,6,0,1,3,4,3,6
Walsall Wood,7,2,1,10,23,9,7,1,5,13,25,25
Lancing,1,3,2,6,12,16,4,0,1,5,9,3
Ulm,0,0,0,0,0,0,0,1,1,2,3,4
Sidmouth Town,0,0,0,0,0,0,0,0,1,1,0,5
Voltigeurs de Chateaubriant,1,1,1,3,2,1,5,0,0,5,10,3
Dallas,58,30,9,97,188,93,22,25,46,93,89,149
Aktobe,4,6,8,18,22,25,1,4,6,11,7,24
Southam United,0,0,1,1,1,5,0,0,0,0,0,0
Fidelis And.,0,0,0,0,0,0,0,1,0,1,1,1
Elfsborg,60,36,21,117,205,121,34,33,47,114,156,193
Hamilton,50,45,65,160,211,226,40,34,85,159,165,291
Takeley,0,0,1,1,0,2,0,0,2,2,3,7
Brazil,37,13,8,58,112,39,24,5,1,30,72,14
Antalyaspor,42,35,37,114,155,151,32,31,52,115,121,193
Mantova,0,0,1,1,0,4,1,1,1,3,6,5
El Salvador,11,5,11,27,30,34,6,9,21,36,21,59
Rad Beograd,48,30,50,128,143,159,24,25,82,131,94,218
SSV Jeddeloh II,0,0,1,1,2,5,0,0,0,0,0,0
Eq Guinea,5,2,4,11,14,7,2,6,11,19,11,26
Amorebieta,2,0,3,5,5,6,0,2,2,4,4,10
Bluebell Utd,1,0,1,2,3,4,0,0,2,2,0,2
Svyturys,0,0,1,1,0,2,0,0,0,0,0,0
Fuenlabrada,17,23,9,49,60,46,21,18,15,54,62,58
FK Pobeda,2,0,1,3,3,4,1,0,1,2,3,4
Dyn Dresden,28,23,27,78,107,103,25,17,35,77,100,128
Sleaford Town,1,1,1,3,6,6,3,1,2,6,22,18
Qormi,0,0,1,1,0,2,0,0,1,1,0,2
Fraga,0,0,1,1,0,1,0,0,0,0,0,0
Puskas FA FC,46,26,32,104,140,117,30,24,51,105,128,168
Grimsby,78,58,65,201,264,225,66,42,87,195,231,277
Hallescher,4,2,4,10,19,23,0,4,1,5,2,3
Molde,89,22,19,130,316,122,59,29,42,130,209,172
Pontellas,0,0,0,0,0,0,0,0,1,1,0,1
Hackney Wick,0,0,0,0,0,0,0,0,1,1,0,7
Horsham YMCA,2,0,3,5,7,10,1,0,2,3,10,7
Terbuni Puke,0,0,1,1,0,2,0,0,2,2,0,8
Rochdale Town,0,0,1,1,2,4,0,0,0,0,0,0
Warta Poznan,6,2,7,15,14,15,6,2,6,14,18,17
Dunajska Streda,6,3,4,13,24,19,5,1,5,11,17,22
Boldmere St. M,1,0,3,4,7,11,1,0,2,3,3,6
NK Istra 1961,34,41,58,133,122,187,15,30,88,133,98,250
Chad,2,0,1,3,3,3,0,1,2,3,1,6
Bugbrooke St Michaels,0,0,1,1,1,2,0,0,0,0,0,0
Three Bridges,1,0,2,3,6,8,3,0,6,9,10,19
AC Oulu,0,0,1,1,0,2,0,0,1,1,1,3
Maritimo,63,28,41,132,172,137,26,30,75,131,102,215
Ulsan Hyundai,0,0,1,1,1,3,0,0,1,1,1,2
Berre,0,0,1,1,1,2,0,0,0,0,0,0
Konyaspor,54,47,34,135,172,137,35,44,61,140,145,197
Poland Women,0,1,1,2,1,4,0,0,0,0,0,0
Bochum,51,33,22,106,190,130,35,30,48,113,141,163
Nacional,33,24,36,93,114,120,13,22,59,94,82,190
Gabon,6,8,7,21,18,21,4,11,9,24,22,28
FC Vaslui,4,0,4,8,13,11,3,1,3,7,4,6
Jonava,0,0,2,2,1,7,1,1,0,2,2,1
Buckie Thistle,35,9,20,64,148,100,26,10,28,64,151,123
Hungerford,67,35,49,151,208,161,60,31,68,159,218,247
Welling Town,2,0,1,3,11,8,0,0,0,0,0,0
Cook Islands,1,0,0,1,1,0,1,0,1,2,3,2
Javor,35,26,34,95,111,115,17,27,53,97,83,153
Diss Town,0,0,1,1,2,3,0,0,0,0,0,0
Chasetown,8,2,1,11,28,10,0,0,6,6,4,17
Viry-Chatillon,2,0,1,3,5,8,1,0,1,2,2,3
Ciliverghe,0,0,0,0,0,0,0,0,1,1,0,3
Khimki,10,1,4,15,22,14,4,4,7,15,18,26
V N Novgorod,2,0,5,7,5,13,1,0,6,7,3,18
Sogndal,15,14,17,46,64,60,7,12,26,45,39,76
Wasquehal,0,0,1,1,0,1,0,0,0,0,0,0
B Petrolspor,0,0,1,1,0,3,0,0,0,0,0,0
Ravensburg,0,0,1,1,0,2,0,0,0,0,0,0
AD San Juan,0,0,1,1,0,2,0,0,0,0,0,0
MTK,45,16,29,90,117,87,25,25,40,90,101,137
Beselidhja,0,0,1,1,0,1,0,0,0,0,0,0
Egham Town,2,0,4,6,14,17,1,1,4,6,3,13
FC Emmen,17,11,18,46,72,83,7,11,28,46,34,101
Seaford Town,1,0,0,1,1,0,0,0,2,2,2,12
Burnley,69,40,55,164,196,177,49,46,68,163,179,240
Lingfield,2,0,0,2,10,2,0,0,2,2,5,14
Ardley United,0,0,1,1,1,2,0,0,0,0,0,0
Royal Antwerp,38,23,20,81,132,104,34,16,30,80,106,117
Brantham Ath,0,0,2,2,1,7,1,0,2,3,6,8
Ujpest Dozsa,50,40,32,122,174,144,37,34,51,122,146,178
Spakenburg,0,0,0,0,0,0,0,0,1,1,0,7
Condal Club,0,0,1,1,2,8,0,0,0,0,0,0
Fenerbahce,96,36,23,155,288,155,66,43,46,155,230,174
Cordoba II,0,0,0,0,0,0,0,1,0,1,0,0
Bowers & Pitsea,11,7,11,29,56,39,12,6,11,29,53,46
Sandnes Ulf,4,5,6,15,14,20,0,5,10,15,13,33
Etoile Carouge,0,0,1,1,0,1,0,0,0,0,0,0
Denmark Women,1,1,2,4,7,5,1,0,4,5,5,10
Drancy,0,0,1,1,0,1,1,0,2,3,5,7
AFC Bridgnorth,0,0,1,1,1,2,2,0,2,4,6,7
East Fife,65,38,54,157,239,219,53,22,74,149,181,219
S Africa Olympic,0,1,0,1,1,1,0,1,1,2,0,1
Herediano,3,1,0,4,11,4,1,1,2,4,6,10
Dorchester,55,36,66,157,208,248,33,28,86,147,191,318
Gainsborough,58,34,53,145,216,206,40,22,85,147,173,284
Lanciano,1,2,2,5,4,6,0,3,2,5,2,5
Leganes,67,44,38,149,183,136,37,37,77,151,134,205
Aris Salonika,28,17,20,65,90,61,17,20,27,64,67,88
Harrow Boro,57,34,58,149,239,231,46,30,81,157,224,303
Hard,0,0,1,1,0,3,0,0,0,0,0,0
Consett,8,0,3,11,30,11,3,1,1,5,17,10
Toulon,0,0,0,0,0,0,0,1,0,1,1,1
St Vin & Gren,3,2,4,9,13,20,0,1,5,6,9,32
Brunei,2,0,1,3,6,3,1,0,3,4,2,11
Lusitanos,1,3,4,8,9,16,1,3,3,7,6,10
Zambia,12,9,3,24,40,18,10,8,12,30,34,36
Hibernians,5,1,9,15,21,30,7,4,10,21,30,38
Tritium,0,0,0,0,0,0,0,0,1,1,1,2
Ukraine,23,6,7,36,49,21,13,10,10,33,44,47
FV Engers 07,0,0,1,1,0,3,0,0,0,0,0,0
Real Betis II,0,1,0,1,0,0,1,1,1,3,4,3
HIFK Helsinki,26,27,22,75,89,85,17,22,38,77,94,119
Ghetto,0,0,1,1,1,8,0,0,0,0,0,0
Fairford Town,0,0,2,2,1,3,1,0,1,2,3,6
Ap. Larissa,0,0,2,2,0,11,0,0,0,0,0,0
Erith Town,2,0,3,5,10,8,2,0,0,2,5,1
Willem II,40,28,48,116,155,181,31,23,61,115,139,209
FC Andorra,1,1,0,2,4,1,0,1,1,2,0,2
Balzan,4,5,6,15,28,31,5,0,12,17,16,29
Mladost Velika,0,1,0,1,1,1,0,0,3,3,1,8
Chelsea U23,1,1,0,2,4,3,0,0,3,3,4,7
Viimsi II,0,0,1,1,0,13,0,0,0,0,0,0
Valur,13,1,4,18,36,16,3,4,10,17,16,29
Holmesdale,0,0,1,1,2,4,0,0,0,0,0,0
Oakham Utd,0,0,0,0,0,0,0,0,1,1,1,8
Caudal,2,0,0,2,3,1,0,0,1,1,1,4
Optik Rathenow,0,0,2,2,2,5,0,0,0,0,0,0
Socuellamos,1,0,2,3,2,4,1,0,2,3,3,6
Lausanne,19,12,34,65,93,109,17,17,28,62,83,103
Laval,6,6,6,18,17,20,3,9,10,22,19,32
Boness Utd,6,3,2,11,29,20,2,2,2,6,16,13
Ilford,1,0,2,3,6,6,0,0,1,1,2,3
Belarus U21,0,0,1,1,0,4,0,1,2,3,3,6
Barnet,78,39,68,185,255,244,56,49,80,185,225,276
Kaiserslautern II,0,0,1,1,0,1,0,0,0,0,0,0
Stamford,21,18,32,71,103,121,25,11,31,67,96,114
Watford,84,34,47,165,260,192,50,36,88,174,191,273
Bardon Hill Sports,0,0,1,1,3,4,0,0,0,0,0,0
Larissa,24,29,24,77,75,78,10,22,47,79,51,129
Micronesia,0,0,1,1,0,30,0,0,1,1,0,46
Morecambe,62,50,75,187,244,264,50,51,93,194,213,316
Unione Venezia,3,0,2,5,10,5,0,1,2,3,4,8
Norton U,2,1,1,4,9,9,2,0,1,3,7,8
Bury,67,33,47,147,234,183,42,40,63,145,160,211
Freiburg,65,32,36,133,222,174,35,40,64,139,169,239
Shamrock R,81,27,26,134,240,110,65,29,37,131,180,124
Perugia,13,5,5,23,38,25,4,5,12,21,31,46
St Pauli,43,31,31,105,147,128,33,24,52,109,125,178
Pakistan,1,1,2,4,3,5,0,0,2,2,1,5
Bishop Sutton,0,0,1,1,0,3,0,0,0,0,0,0
Inverurie Locos,36,11,14,61,180,85,37,3,17,57,138,81
FC Twente,42,30,34,106,172,155,24,28,53,105,126,183
Gyirmot FC Gyor,3,3,10,16,10,23,2,6,9,17,11,28
Kazakhstan,7,6,13,26,35,38,6,10,17,33,28,57
FK Petrovac,0,0,2,2,1,4,0,0,1,1,0,3
S'derland R CW,4,1,1,6,17,3,1,0,2,3,6,10
Wythenshawe Town,1,2,0,3,5,4,1,1,1,3,7,6
Paganese,0,0,0,0,0,0,0,0,1,1,0,6
N. Chicago,0,0,0,0,0,0,0,0,1,1,1,3
Energosbyt-BSATU,0,0,1,1,0,7,0,0,0,0,0,0
Ayr,65,35,56,156,237,195,64,30,67,161,266,245
Huntly,23,11,24,58,105,119,18,9,34,61,83,158
Zlin,37,22,39,98,111,132,20,23,54,97,86,155
Gibraltar,4,2,22,28,14,97,2,2,22,26,7,95
Bideford,20,18,21,59,82,88,13,11,41,65,69,147
Koralas,0,0,1,1,0,4,0,0,0,0,0,0
Wodson Park,0,0,1,1,0,2,1,0,0,1,2,0
Renfrew,0,0,3,3,4,9,0,0,1,1,0,3
Hauts Lyonnais,0,1,0,1,0,0,0,0,0,0,0,0
F Dusseldorf,44,24,35,103,143,142,37,29,50,116,155,193
Brighton,75,50,50,175,237,190,53,54,72,179,189,227
Villarreal,102,41,46,189,329,199,75,58,67,200,263,238
Leamington,74,42,43,159,244,169,44,47,63,154,194,227
Mogren,1,0,0,1,3,2,3,0,0,3,7,1
Southport,53,43,66,162,217,239,45,40,76,161,180,260
Blackburn Utd,0,0,2,2,4,7,0,0,2,2,2,6
Al Ain,0,1,0,1,3,3,0,1,1,2,3,6
GAIS,1,0,0,1,4,1,0,0,2,2,0,7
Bourges Foot,0,0,2,2,0,4,0,0,0,0,0,0
Cogenhoe Utd,2,0,2,4,5,5,2,1,1,4,9,10
Tilbury,5,0,3,8,24,16,0,2,4,6,10,18
Seychelles,0,2,6,8,2,19,0,0,11,11,4,41
Numancia,65,42,39,146,194,146,22,66,59,147,135,201
Japan Olympic,1,1,0,2,3,2,0,0,1,1,4,5
Langreo,0,0,2,2,3,5,0,1,0,1,2,2
Tadcaster Alb.,4,0,6,10,17,16,3,3,4,10,14,21
Salernitana,7,5,2,14,25,13,1,6,10,17,14,32
KPV Kokkola,4,3,8,15,15,24,3,4,9,16,18,27
Libourne S-S,0,0,1,1,0,2,0,0,0,0,0,0
St. Johnstone U20,2,1,3,6,7,10,2,2,2,6,11,11
FC Kosice,2,1,2,5,5,4,0,0,4,4,0,8
Aylesbury FC,2,2,3,7,11,11,0,0,3,3,3,11
Bhutan,2,0,5,7,6,17,1,0,6,7,3,53
Dordrecht,3,4,10,17,15,34,1,4,12,17,9,42
Ludogorets,111,39,24,174,355,125,86,54,36,176,304,170
Casertana,3,0,0,3,7,2,1,2,6,9,5,18
Acad Coimbra,10,21,12,43,47,58,5,13,25,43,32,68
Degerfors,1,0,1,2,2,1,1,0,3,4,5,8
Preston,87,61,50,198,303,220,74,49,71,194,235,240
Aberystwyth,44,23,52,119,207,219,39,30,46,115,180,208
CD Calahorra,3,2,2,7,7,5,0,0,2,2,1,4
Ranheim,13,6,12,31,54,50,7,6,17,30,29,55
Hafnarfjordur,13,9,6,28,37,27,14,10,6,30,45,34
Serbia U21,3,3,3,9,7,10,4,2,6,12,11,18
Osnabruck,9,7,25,41,48,70,10,15,15,40,42,58
Plabennec,0,0,0,0,0,0,1,0,3,4,3,9
Arcahaie,0,1,0,1,0,0,0,0,1,1,0,8
VVV Venlo,18,16,29,63,78,117,14,14,35,63,70,135
Ghana Women,0,0,0,0,0,0,0,1,0,1,0,0
Poole Town,79,29,37,145,265,163,67,38,50,155,242,190
Jeunesse Evolution,0,0,1,1,0,2,0,0,0,0,0,0
Rushden & H U,0,0,1,1,0,2,0,0,0,0,0,0
Taraz,1,0,2,3,4,4,0,0,8,8,2,26
Jodan Boys,0,0,0,0,0,0,1,0,1,2,2,5
England,34,6,6,46,104,27,19,11,9,39,65,34
Rabotnicki,11,6,6,23,36,24,5,4,11,20,29,33
Imolese,0,1,0,1,3,3,1,1,3,5,5,11
Honka,27,19,14,60,86,63,21,22,20,63,84,90
Latvia,5,6,18,29,19,48,4,15,18,37,35,61
Bournemouth,77,41,55,173,286,237,57,36,78,171,230,261
Darlington Railway Athletic,0,0,0,0,0,0,0,0,1,1,0,4
Stip,1,0,1,2,1,1,0,0,2,2,1,5
Arras,0,0,0,0,0,0,0,0,1,1,0,2
Comillas,0,1,1,2,1,6,0,0,0,0,0,0
Hearts,89,38,37,164,324,171,58,39,63,160,201,218
Downton,0,0,1,1,0,4,0,0,1,1,4,6
Bishop's Cleeve,2,0,4,6,11,12,1,0,3,4,4,12
Ashton & Backwell United,0,0,0,0,0,0,0,0,1,1,1,2
Morocco,30,9,11,50,88,33,8,9,7,24,22,18
Alessandria,10,2,2,14,21,10,6,3,8,17,22,27
Farnborough,51,17,60,128,201,233,32,19,71,122,165,278
Sandweiler,0,0,1,1,0,6,0,0,0,0,0,0
Chester,67,37,54,158,259,218,43,43,80,166,184,272
Osasuna,68,47,42,157,205,181,48,45,73,166,160,241
Leon,2,2,0,4,8,3,0,0,3,3,2,7
Sweden Olympic,0,1,1,2,2,3,0,0,1,1,0,1
Gazovik Orenburg,16,14,16,46,47,48,10,10,26,46,45,74
Ch. Odessa,21,31,31,83,71,94,12,24,47,83,62,134
Falmouth Town,3,0,0,3,9,4,2,1,3,6,17,13
UE Sant Julia,4,5,4,13,12,14,2,3,9,14,10,26
Shaftesbury T,0,0,2,2,2,5,1,0,0,1,3,1
Freiburg II,0,1,0,1,1,1,0,0,0,0,0,0
VfB Germania H,0,0,2,2,1,8,0,0,0,0,0,0
Prato,0,0,0,0,0,0,0,0,1,1,0,1
Rotherham,71,44,69,184,274,257,45,41,97,183,197,304
B36 Torshavn,9,8,8,25,41,35,11,7,7,25,38,35
Raunds Town,0,0,1,1,0,1,0,0,0,0,0,0
FK Mladost Doboj Kakanj,1,0,1,2,1,3,0,0,2,2,1,6
Chester-le-Street Town,0,0,1,1,0,4,1,0,1,2,3,2
Barakaldo,7,4,3,14,24,14,2,3,3,8,6,9
Uruguay,24,5,5,34,70,26,16,9,18,43,54,53
Toronto FC,59,23,24,106,209,123,31,30,43,104,147,173
Nice II,0,0,1,1,0,3,0,0,0,0,0,0
Macva Sabac,22,15,34,71,61,93,7,15,48,70,43,125
Algeria,24,7,3,34,80,23,12,8,13,33,46,45
Garching,0,0,0,0,0,0,0,0,1,1,0,3
Calne Town,0,0,3,3,3,10,0,0,0,0,0,0
Piatra Neamt,3,10,11,24,17,32,6,4,15,25,16,39
Fort William,2,5,42,49,52,245,3,4,45,52,30,296
M d'Or Azergues,0,1,1,2,1,4,0,0,0,0,0,0
Stranraer,72,27,61,160,252,233,44,41,68,153,184,255
US Ste Marie,0,0,0,0,0,0,0,0,1,1,0,2
Bate Borisov,100,33,15,148,297,110,84,28,35,147,252,171
G. Torrelavega,0,0,3,3,1,7,0,1,0,1,1,1
Zug,0,0,1,1,0,1,0,0,0,0,0,0
Barquereno,0,0,0,0,0,0,0,1,0,1,1,1
Gravelines,0,0,1,1,0,3,0,0,0,0,0,0
Chelmsley T,0,0,0,0,0,0,0,0,2,2,3,7
Pacos Ferreira,46,30,34,110,136,133,23,30,58,111,105,185
Liversedge,1,0,0,1,5,2,1,1,2,4,7,7
FC Lusitans,0,1,4,5,3,9,2,1,2,5,7,9
St Marg'sbury,3,0,2,5,14,10,1,0,0,1,1,0
Scotland,17,7,8,32,51,35,10,6,14,30,38,42
Mersin,12,7,15,34,48,55,6,7,21,34,37,64
Stockport Town,1,0,3,4,9,11,1,0,0,1,2,0
San Roque,0,1,0,1,2,2,0,1,0,1,1,1
Mamelodi S,0,0,1,1,0,2,0,0,1,1,1,4
Mirandes,47,45,34,126,150,131,36,28,61,125,138,197
Ancona,1,0,0,1,4,3,1,0,2,3,2,6
Wellington Amateurs,0,0,1,1,1,2,0,0,0,0,0,0
Maidenhead,72,38,63,173,264,228,61,38,70,169,241,266
Seregno,0,0,0,0,0,0,0,1,1,2,0,3
Macedonia U21,4,1,1,6,10,5,1,1,3,5,4,10
FC Timisoara,20,20,28,68,69,89,11,23,33,67,51,109
Prestatyn,8,8,22,38,48,73,4,7,28,39,44,104
Pirin,19,16,23,58,71,73,9,14,34,57,44,89
Bnei Sakhnin,33,31,48,112,101,142,33,28,52,113,113,163
Minnesota U,33,14,16,63,107,76,15,11,43,69,92,149
Jamaica,12,8,7,27,38,29,15,4,22,41,43,61
Lanusei,0,0,0,0,0,0,0,0,1,1,0,2
Everton,87,40,47,174,298,206,55,42,71,168,210,246
Troyes,16,13,26,55,63,81,11,8,40,59,59,118
Torpedo Kutaisi,8,0,4,12,24,15,5,0,6,11,16,18
Borec,0,0,0,0,0,0,0,1,0,1,1,1
Sittingbourne,2,2,3,7,5,7,3,2,3,8,11,10
Cibao FC,0,0,1,1,0,2,0,0,1,1,0,5
Delta Porto Tolle,0,0,0,0,0,0,0,0,1,1,0,3
Pecsi Munkas,8,7,7,22,23,26,6,4,11,21,25,36
Thurrock,15,5,9,29,50,41,6,2,18,26,39,59
Fiji Olympic,0,0,2,2,1,13,0,0,1,1,0,10
BSC Glasgow,38,9,11,58,142,56,31,12,12,55,119,80
Guingamp,49,32,39,120,158,139,38,28,72,138,137,229
Laredo,2,0,2,4,7,6,0,0,2,2,1,5
FK Qarabag,73,27,15,115,206,78,44,23,34,101,135,103
Slovenia U21,0,1,1,2,1,4,0,1,1,2,1,5
Foligno,0,0,0,0,0,0,0,0,1,1,0,5
Frejus Saint-Raphael,5,2,3,10,16,10,4,2,2,8,12,7
Zvijezda,0,0,0,0,0,0,1,0,2,3,3,7
Paraguay,6,8,4,18,24,23,8,13,25,46,38,70
Charlton U21,0,0,0,0,0,0,0,0,1,1,0,3
Rothes,30,7,21,58,132,93,18,9,23,50,88,112
Inter Miami CF,5,3,4,12,17,18,3,2,11,16,13,25
Musselburgh Ath,2,0,0,2,8,3,0,0,0,0,0,0
Falkenbergs FF,20,17,39,76,92,132,11,13,53,77,70,175
Cardiff U23,0,1,0,1,1,1,0,0,0,0,0,0
Newton S,0,0,1,1,0,4,0,0,0,0,0,0
Lithuania,7,6,14,27,24,43,6,6,26,38,18,80
Acharnaikos,0,0,1,1,0,3,0,0,0,0,0,0
Arbroath,65,38,51,154,240,185,56,35,61,152,226,231
FC Schotz,0,0,1,1,2,3,0,0,0,0,0,0
Uruguay Women,0,0,0,0,0,0,0,0,1,1,1,3
Baltika,0,1,1,2,3,4,0,0,0,0,0,0
Napredok,0,0,0,0,0,0,0,0,1,1,0,4
Revan,1,0,1,2,3,3,0,1,2,3,2,4
Kukesi,11,8,7,26,34,30,6,7,12,25,28,36
Zilina,11,2,7,20,46,26,13,2,12,27,53,46
Kottmannsdorf,0,0,1,1,0,9,0,0,0,0,0,0
Lierse,9,10,16,35,39,59,10,2,23,35,41,73
Korabi Peshkopi,0,0,1,1,1,3,0,0,2,2,0,5
Granada,74,36,49,159,198,172,42,37,94,173,184,313
KSV Hessen Kassel,0,0,1,1,0,2,1,0,0,1,2,1
FC Tiraspol,4,1,1,6,10,6,0,1,3,4,5,9
Gorno Lisice,0,0,0,0,0,0,0,0,1,1,0,2
Wattenscheid,0,0,1,1,1,2,0,0,1,1,1,3
Cottesmore Amateurs S&S,0,0,0,0,0,0,0,0,1,1,1,3
C Leonesa,15,11,9,35,50,46,9,8,16,33,46,64
Panama,16,14,12,42,43,34,13,11,29,53,49,94
Malta,5,7,17,29,23,54,2,6,27,35,13,72
Lye Town,4,0,1,5,19,6,0,1,1,2,4,5
Union St Gilloise,4,3,3,10,23,19,6,0,5,11,19,14
Mamurrasi,0,0,1,1,0,8,0,0,1,1,1,9
Hungary,18,8,14,40,58,48,11,7,12,30,36,38
Lecco,0,0,0,0,0,0,0,0,1,1,0,2
Turris,0,0,0,0,0,0,0,0,1,1,0,1
Zimbabwe,8,4,3,15,26,13,3,7,8,18,14,17
Moulins,2,2,1,5,7,5,1,2,0,3,7,2
1299 Osmanlispor,23,16,21,60,88,75,18,17,24,59,78,80
Enfield T,85,38,32,155,303,187,55,31,72,158,228,241
Atl Granadilla,0,0,0,0,0,0,0,0,1,1,0,2
R. Rostov,60,34,26,120,159,97,33,34,53,120,123,167
Atromitos,61,38,32,131,168,107,42,37,52,131,137,166
Bognor Regis,82,30,42,154,298,185,59,42,61,162,232,222
Marbella,3,1,4,8,8,9,1,0,1,2,3,4
Whitton Utd,0,0,1,1,1,3,0,0,3,3,4,9
Oostende,62,35,46,143,240,208,39,34,68,141,161,229
Brocton,3,0,1,4,14,9,3,0,3,6,17,14
Indonesia,6,4,8,18,26,25,2,2,4,8,9,17
Maag Tammeka,0,1,5,6,3,20,0,1,2,3,1,5
St Albans,72,33,48,153,261,200,50,37,66,153,197,239
Denmark U21,7,2,4,13,25,22,7,2,6,15,18,20
Hoffenheim II,1,0,0,1,2,1,0,1,1,2,1,2
St Pryve-St Hilaire,5,0,2,7,12,8,0,2,0,2,1,1
Hertford Town,2,1,1,4,8,8,0,0,6,6,5,21
07 Vestur,0,0,2,2,2,5,0,0,2,2,0,5
Edgware Town,1,0,2,3,6,8,1,0,1,2,3,4
Puerto Rico,2,2,3,7,7,9,0,2,6,8,4,21
Trikala,0,1,0,1,0,0,0,0,0,0,0,0
Rothwell Cor.,0,0,2,2,2,5,2,0,1,3,4,4
Banik Ostrava,38,32,33,103,137,112,25,22,58,105,102,169
Helios,0,0,1,1,0,13,0,0,0,0,0,0
Cheminots Paray,0,0,1,1,0,4,0,0,0,0,0,0
Chemnitzer,2,3,5,10,14,24,0,0,1,1,1,2
Trabzonspor,75,27,41,143,254,194,52,54,38,144,192,176
Miengo,0,0,1,1,0,1,0,0,0,0,0,0
Worksop,9,1,4,14,33,26,9,3,9,21,32,39
Waterford,50,17,45,112,161,159,35,22,56,113,123,172
Tadley Calleva,1,1,0,2,6,2,1,0,2,3,5,13
KR Reykjavik,10,8,5,23,31,25,10,2,16,28,48,55
Corsham Town,0,0,0,0,0,0,0,0,1,1,0,1
Whitby,63,39,45,147,225,201,41,33,74,148,184,243
Cercle Bruges,24,9,44,77,95,136,12,11,53,76,58,151
Ascot Utd,5,1,0,6,26,2,4,2,5,11,21,21
Brighton U23,3,1,1,5,11,3,2,3,3,8,5,9
Verona,45,27,47,119,163,173,22,33,59,114,110,204
Argentina Olympic,1,1,0,2,3,2,0,0,1,1,0,2
Dinamo Minsk,80,23,31,134,194,103,65,34,33,132,187,125
Georgia U21,0,0,0,0,0,0,0,0,1,1,0,3
Grevenmacher,1,0,3,4,4,13,0,0,1,1,0,3
Gennevilliers,0,0,1,1,0,2,0,0,0,0,0,0
Oadby Town,0,0,0,0,0,0,0,0,1,1,0,5
Loon-Plage,0,0,1,1,0,3,0,0,0,0,0,0
CO Avallonnais,0,0,1,1,0,2,0,0,0,0,0,0
Dinamo Brest,60,26,30,116,204,140,43,27,48,118,156,158
Ossett Albion,0,1,3,4,1,7,0,3,1,4,5,6
Quevilly,5,6,4,15,27,16,5,2,3,10,15,13
Bonaire,0,0,1,1,0,6,0,0,0,0,0,0
Perth Glory,53,18,28,99,191,147,34,27,41,102,144,159
PAOK Salonika,112,31,26,169,327,128,72,45,51,168,228,181
Shrivenham,0,0,1,1,2,3,0,0,0,0,0,0
Pena Deportiva,1,2,4,7,5,9,1,1,0,2,3,2
Vasteras,1,0,0,1,4,0,1,0,1,2,3,2
Cockfosters,0,0,2,2,2,5,1,0,2,3,3,3
La Nucia,0,0,1,1,0,1,1,1,1,3,4,4
Braunschweig,36,21,22,79,111,90,18,28,39,85,84,126
Rennes TA,1,0,0,1,1,0,0,0,1,1,0,3
Bermuda,6,0,4,10,29,12,4,2,8,14,18,28
Norwich CBS,3,0,0,3,6,3,2,0,3,5,10,16
NSI Runavik,5,5,8,18,29,32,6,3,8,17,24,33
Bekescsaba,4,5,8,17,16,22,3,4,10,17,11,33
Gorodeya,27,27,21,75,93,84,18,24,34,76,72,100
Sauchie,1,1,1,3,8,6,0,1,2,3,4,10
Liria Prizren,0,0,0,0,0,0,0,0,1,1,1,3
Fareham Town,2,0,0,2,8,4,1,0,4,5,6,13
Coventry United,7,1,1,9,27,11,3,2,2,7,15,8
Livingston,76,32,58,166,236,164,63,36,68,167,243,239
M Tetouani,0,1,0,1,0,0,0,0,0,0,0,0
Barrow,83,51,45,179,278,190,63,49,69,181,232,247
Dilj,0,0,1,1,0,6,0,0,0,0,0,0
Mexico,46,15,10,71,127,59,22,12,13,47,66,56
Orleans,5,7,8,20,26,27,8,7,8,23,35,35
Spartaks Jurmala,8,8,5,21,31,19,4,4,7,15,22,25
Bayonne,0,0,1,1,0,2,0,0,0,0,0,0
AZ Alkmaar,88,37,30,155,310,168,71,29,52,152,255,224
Romulus,1,2,2,5,8,12,1,2,3,6,11,13
Quorn,3,0,3,6,13,14,3,0,3,6,14,12
Sherwood Col,0,0,0,0,0,0,2,0,3,5,12,11
Ossett Town,1,1,4,6,8,10,1,2,2,5,4,8
Novi Pazar,36,16,26,78,102,88,11,16,49,76,56,134
Palermo,22,18,30,70,84,101,14,19,32,65,69,121
Wiedenbruck,0,1,1,2,0,5,0,0,0,0,0,0
HVV Te Werve,0,0,1,1,0,7,0,0,0,0,0,0
Northampton,82,49,64,195,265,226,61,50,87,198,253,316
Real Sociedad II,0,1,0,1,0,0,0,1,1,2,1,2
Corinthian Cas,21,12,18,51,71,65,9,8,31,48,50,96
Bustleholme,0,0,1,1,1,4,0,0,0,0,0,0
Hacken,59,26,28,113,227,119,38,34,41,113,142,142
TuS Koblenz,0,0,1,1,2,3,0,0,0,0,0,0
Lazio,109,32,40,181,374,203,78,39,64,181,271,254
NK Vitez,0,0,1,1,0,3,1,0,2,3,1,5
Colomiers US,0,0,0,0,0,0,0,0,1,1,2,5
08 Villingen,0,0,2,2,2,7,0,0,0,0,0,0
IA Akranes,0,0,0,0,0,0,1,3,0,4,6,5
Taranto,0,0,0,0,0,0,0,0,1,1,1,5
Longwell Green Sports,0,0,1,1,1,3,0,0,2,2,2,5
Varbergs Bois,7,4,7,18,28,29,5,5,10,20,29,32
Red Star,133,23,12,168,402,110,113,30,23,166,343,149
Hednesford,49,33,46,128,186,170,40,26,64,130,180,234
Smethwick,0,0,1,1,0,3,0,0,0,0,0,0
Austin FC,0,0,0,0,0,0,2,0,2,4,5,5
Estoril,32,19,31,82,101,105,20,25,37,82,80,124
Colwyn Bay,12,11,35,58,64,115,15,18,27,60,81,116
H Tel Aviv,38,37,37,112,135,122,35,35,40,110,102,133
Tijuana,0,1,1,2,1,3,1,0,1,2,2,3
Podbrezova,3,1,3,7,7,6,1,0,6,7,2,15
Eintracht Trier,0,0,2,2,0,5,0,0,0,0,0,0
Honduras Olympic,1,0,2,3,6,7,1,1,1,3,2,7
Broadfields U,1,0,2,3,4,11,0,0,2,2,1,5
Harrogate,92,43,47,182,338,223,68,37,70,175,254,255
F. Sittard,18,11,17,46,76,73,9,8,29,46,49,112
Glebe,1,0,1,2,1,2,3,1,2,6,14,14
A Villa U21,6,0,3,9,21,11,1,0,7,8,9,27
Hull,84,42,60,186,275,220,54,46,94,194,232,312
Tuffley Rovers,1,0,1,2,4,2,0,0,2,2,2,8
St Gallen,57,26,52,135,210,211,37,30,68,135,164,243
Triglav,17,8,37,62,79,138,12,15,35,62,62,133
Runcorn Linnets,4,3,2,9,17,16,5,1,3,9,19,18
Gibraltar Utd,0,0,0,0,0,0,0,0,1,1,0,2
Dudley Sports,1,1,0,2,3,2,0,0,0,0,0,0
Edinburgh Uni,12,11,33,56,59,121,9,13,30,52,51,116
Pena Azagresa,0,0,1,1,0,2,1,0,0,1,1,0
Matlock,64,35,49,148,220,190,46,28,81,155,203,278
Hanworth Villa,2,2,2,6,10,12,1,2,2,5,11,8
Sandecja N S,4,8,6,18,18,21,2,7,10,19,16,33
BKV Elore,0,0,1,1,1,3,0,0,0,0,0,0
Houston Dyn,5,3,3,11,20,14,2,4,5,11,8,13
Moneyfields,4,2,3,9,12,17,3,0,3,6,6,16
Mattersburg,34,19,35,88,113,143,21,21,45,87,101,152
Lusitano GC E,0,0,1,1,0,6,0,0,0,0,0,0
St Mochtas,0,0,0,0,0,0,0,0,1,1,2,3
Viktoria Koln,3,1,5,9,16,22,2,1,0,3,4,1
Lower Breck,2,0,1,3,6,8,1,0,2,3,6,5
Bourg en Bresse,0,1,2,3,0,5,2,1,2,5,8,6
Aris Limassol,0,0,1,1,0,3,0,0,1,1,0,4
Las Palmas II,0,0,0,0,0,0,0,1,1,2,1,2
FC Brasov,9,7,9,25,31,31,5,7,12,24,16,30
Newport (IOW),5,0,4,9,26,17,3,1,3,7,11,11
Canvey Isl.,34,21,35,90,139,154,26,27,41,94,130,177
Le Havre,9,2,3,14,31,24,4,9,8,21,20,27
Colombia Olympic,1,0,0,1,2,0,0,2,1,3,4,6
Rosyth,0,0,1,1,3,5,0,0,0,0,0,0
Alania Vlad.,0,0,1,1,1,3,0,0,0,0,0,0
Yaxley,5,1,4,10,24,17,3,2,3,8,10,12
Sebail,0,1,2,3,1,7,0,0,5,5,0,12
Camelford,0,0,1,1,1,2,0,0,2,2,1,6
JS St Jean Beaulieu,0,0,0,0,0,0,0,0,1,1,2,10
Real Union,0,1,0,1,1,1,0,2,2,4,3,5
Gallia Lucciana,1,0,0,1,4,0,0,0,0,0,0,0
Montserrat,0,2,0,2,3,3,0,1,1,2,3,4
Tartu FC Santos,4,0,1,5,16,10,3,0,1,4,17,8
FC Schaffhausen,0,0,2,2,2,5,0,1,1,2,1,3
Reims II,1,1,1,3,5,3,0,1,0,1,1,1
Preston Ath.,1,0,4,5,5,10,1,1,3,5,7,13
Haugesund,50,31,32,113,189,148,36,25,52,113,129,171
Fontenay,1,0,0,1,3,0,0,1,0,1,0,0
Threave Rovers,0,0,2,2,2,7,1,0,5,6,2,23
Poland U21,5,2,5,12,21,14,2,2,2,6,6,11
Chikhura Sach.,7,5,7,19,27,25,7,7,8,22,21,27
Terek Grozny,46,33,30,109,136,108,34,26,51,111,101,145
Arges Pitesti,7,7,5,19,25,19,6,5,7,18,17,26
Willand Rovers,6,0,3,9,21,13,1,0,3,4,7,13
Grenada,2,2,4,8,9,16,0,0,4,4,0,16
Balingen,0,0,1,1,2,3,0,0,2,2,0,7
Freienbach,0,0,1,1,2,11,0,0,0,0,0,0
Chadderton,1,0,2,3,3,9,1,0,3,4,7,11
Formentera,4,8,3,15,17,20,3,3,7,13,12,28
FK Iskra,0,1,1,2,1,2,0,1,0,1,0,0
Navalcarnero,3,1,2,6,6,10,0,1,1,2,2,4
CD Tudelano,2,1,1,4,4,3,0,0,2,2,0,5
Everton U21,5,2,5,12,18,16,5,6,6,17,22,18
Watford U21,1,0,0,1,2,1,1,0,0,1,2,1
Union,0,0,1,1,2,6,0,0,0,0,0,0
Avondale,0,0,0,0,0,0,0,1,1,2,0,2
La Roche-sur-Yon,0,0,1,1,0,3,0,0,0,0,0,0
Luxembourg U21,0,0,0,0,0,0,0,0,1,1,1,4
Aylesbury,1,3,4,8,17,19,3,1,1,5,13,8
Carrarese,1,1,3,5,6,7,0,0,2,2,0,6
Sevastopol,2,0,2,4,6,4,2,1,3,6,4,9
Granit Mikashev,9,8,12,29,27,43,8,8,15,31,24,55
Usti nad Labem,0,0,0,0,0,0,0,0,1,1,0,2
Farense,3,6,7,16,18,20,3,4,9,16,12,24
Dijon,41,29,39,109,145,147,21,26,70,117,129,221
Shakhtyor,83,26,17,126,245,74,63,30,31,124,178,118
At Cirbonero,0,1,1,2,2,4,0,1,0,1,0,0
Berwick,48,27,66,141,191,241,29,30,79,138,138,274
Deutschlandsberger,0,0,1,1,0,7,0,0,0,0,0,0
Corby,33,15,37,85,132,139,30,14,39,83,105,131
Sigma O.,37,28,24,89,126,93,20,23,43,86,86,136
Vojvodina NS,77,23,39,139,215,139,54,41,46,141,165,159
FK Krasnodar,80,36,32,148,275,149,61,41,49,151,207,172
Canada Women,3,1,0,4,6,0,2,1,2,5,4,4
Eccleshall,0,0,0,0,0,0,0,0,1,1,0,3
AC Horsens,22,31,29,82,99,130,21,19,42,82,77,143
Zemplin Michalovce,1,1,5,7,7,12,0,0,5,5,2,16
Rwanda,7,5,5,17,27,15,5,3,6,14,15,20
Coventry Cops,0,0,1,1,0,2,0,0,0,0,0,0
Stumbras,1,2,3,6,4,13,0,0,3,3,2,9
Gran Tarajal,0,0,0,0,0,0,0,0,1,1,0,3
Whickham,0,0,2,2,1,5,0,0,2,2,1,13
Montpellier,65,33,46,144,224,175,46,50,62,158,167,213
Gateshead,79,46,50,175,287,209,55,53,56,164,207,213
H Beer Sheva,101,39,29,169,293,147,66,47,56,169,222,206
Lida,0,0,0,0,0,0,0,0,2,2,2,6
Chorley,81,45,40,166,277,163,57,49,61,167,227,252
Liverpool,126,52,25,203,420,185,104,44,54,202,359,247
Latte Dolce,0,0,0,0,0,0,0,0,1,1,1,2
TuS Dassendorf,0,0,2,2,0,4,0,0,0,0,0,0
Donji Srem,6,6,10,22,25,29,4,7,11,22,14,34
Schalke,67,39,47,153,214,196,52,38,70,160,209,262
Wexford Yth,31,21,52,104,118,159,22,13,65,100,105,220
Tromso,31,23,27,81,132,109,19,12,49,80,88,154
Montelimar,0,0,1,1,1,2,0,0,0,0,0,0
Racing Union,0,0,1,1,1,2,0,0,1,1,0,5
Southampton,67,42,56,165,236,213,60,39,73,172,202,234
Stokesley,0,0,1,1,1,7,0,0,0,0,0,0
Hallam,2,0,3,5,8,12,1,0,2,3,5,6
Wales U21,0,0,0,0,0,0,0,0,1,1,0,2
Sawbridgeworth T,0,0,0,0,0,0,0,0,2,2,0,5
SC Weiche Flensburg 08,1,0,1,2,2,5,0,0,0,0,0,0
St-Etienne,75,54,35,164,229,161,63,43,72,178,195,232
SV Morlautern,0,0,1,1,0,5,0,0,0,0,0,0
Sarpsborg,50,36,26,112,176,120,23,39,50,112,118,191
Mostoles,0,1,0,1,0,0,0,0,0,0,0,0
Hinckley AFC,6,0,1,7,24,9,1,0,3,4,5,13
Almeria,70,51,46,167,241,181,39,42,83,164,152,230
Riom,0,0,0,0,0,0,0,0,1,1,0,1
Bangladesh,0,2,4,6,2,14,1,1,7,9,3,31
Homburg,1,0,2,3,2,6,1,0,1,2,2,2
Hengrove Athletic,2,0,0,2,8,3,0,1,3,4,3,14
Don Benito,0,0,1,1,0,1,0,0,0,0,0,0
SSV Ulm 1846,5,1,4,10,15,16,3,2,2,7,16,9
Risborough Rangers,0,1,1,2,0,2,0,0,1,1,0,1
Clanfield 85,0,0,0,0,0,0,0,1,0,1,1,1
Abbey Rangers,2,1,1,4,11,4,4,0,4,8,13,20
Sertanense,0,0,1,1,0,3,0,0,0,0,0,0
Al-Hilal,2,0,0,2,6,1,1,1,1,3,5,6
Ural Sver. Oblast,40,30,40,110,134,139,28,33,51,112,102,174
Guyana,2,2,4,8,19,23,1,4,5,10,16,18
SV Waldkirch,0,0,1,1,0,3,0,0,0,0,0,0
Sedan,3,1,2,6,10,5,4,2,2,8,12,6
Slovakia,23,9,7,39,65,33,13,5,16,34,44,48
Salford,81,47,28,156,282,158,70,29,47,146,211,164
Bridlington T,1,1,2,4,7,12,1,0,2,3,5,7
Zakarpatty,5,13,14,32,28,52,4,7,19,30,22,53
Tatran Presov,0,0,0,0,0,0,0,0,2,2,1,7
IC Croix Football,6,1,3,10,13,14,2,3,2,7,11,8
Eritrea,0,0,2,2,1,4,0,0,2,2,1,5
Verwood Town,2,0,0,2,7,4,0,0,1,1,1,6
Daisy Hill,0,0,1,1,0,8,0,0,0,0,0,0
Swift,0,0,0,0,0,0,0,0,1,1,1,4
AS Excelsior,0,0,0,0,0,0,0,0,1,1,1,4
Saumur,0,3,3,6,6,10,3,0,0,3,6,1
Cartagena,12,11,10,33,43,40,7,8,15,30,23,40
Riviere-Pilote,0,0,0,0,0,0,0,0,1,1,0,2
B Dortmund II,0,0,0,0,0,0,0,0,1,1,0,2
Belgium Women,1,0,0,1,6,1,0,0,1,1,0,6
Sandhurst T,0,0,1,1,2,6,0,0,1,1,1,6
Auxerre,20,7,9,36,53,29,11,8,11,30,41,39
EB Streymur,0,0,6,6,2,19,1,0,2,3,7,10
FC Elva,0,0,1,1,0,7,0,0,1,1,1,4
B. 1905,47,41,30,118,139,108,25,33,58,116,109,172
Benevento,17,11,29,57,71,101,11,9,29,49,50,101
Radcliffe Olym,0,0,0,0,0,0,0,0,1,1,1,3
Newcastle U23,1,2,0,3,4,3,2,0,2,4,6,7
France U21,4,4,2,10,12,8,3,1,2,6,10,10
Ellesmere Rangers,0,0,0,0,0,0,0,0,1,1,2,3
Spicul Chis,0,0,1,1,0,4,0,0,1,1,0,5
Picerno,0,0,0,0,0,0,0,0,1,1,0,2
FK Klaipedos Granitas,1,0,0,1,2,1,0,1,1,2,0,5
Le Pontet US,0,0,0,0,0,0,0,0,1,1,2,3
NK Split,21,25,20,66,71,69,10,22,34,66,37,86
Clipstone,0,0,0,0,0,0,0,0,2,2,0,3
Padiham,1,0,2,3,4,5,1,1,3,5,3,7
Spartak Myjava,1,0,3,4,5,11,2,1,1,4,4,4
Dronfield Town,1,0,1,2,4,5,1,0,2,3,2,10
Handsworth Parramore,2,0,2,4,14,13,0,0,3,3,2,7
Cardiff MU,37,17,25,79,133,88,25,15,42,82,99,121
FC Santa Coloma,8,11,5,24,24,20,8,5,11,24,27,34
Pro Vercelli,3,0,3,6,9,7,1,1,4,6,7,16
Matera,2,0,1,3,4,2,0,0,2,2,0,2
Teramo,0,0,1,1,0,2,1,0,4,5,7,11
RB Salzburg,127,23,21,171,460,148,104,41,36,181,393,201
Western United,11,4,8,23,42,32,9,3,12,24,32,37
Aubervilliers,0,0,0,0,0,0,0,1,0,1,2,2
Petershill,0,0,1,1,0,7,0,0,1,1,0,6
Cavese,0,0,0,0,0,0,0,0,1,1,1,3
CSMS Iasi,51,32,51,134,146,158,33,38,63,134,127,198
St Michaels,0,1,0,1,0,0,0,0,0,0,0,0
Academica Clinceni,13,12,13,38,38,43,9,13,17,39,40,62
Admira Wacker,42,33,56,131,156,203,34,35,61,130,144,243
Ringmer,0,0,0,0,0,0,0,0,1,1,3,4
Cologne,45,38,44,127,198,172,42,33,64,139,197,229
Sidlesham,0,0,1,1,0,2,0,0,0,0,0,0
Cayolle,0,0,1,1,0,2,0,0,0,0,0,0
Hythe,5,2,2,9,19,10,3,0,5,8,8,21
Clay Cross Town,2,0,0,2,6,2,0,0,1,1,1,3
Man Utd,128,47,31,206,389,168,104,46,63,213,327,229
Loko. Zagreb,63,28,50,141,211,182,42,34,63,139,177,219
Feronikeli,4,0,3,7,9,7,3,1,1,5,14,6
Real Espana,1,1,0,2,4,3,0,0,1,1,0,3
Melbourne Vic,53,19,32,104,192,150,38,24,42,104,144,156
S Navodari,4,0,4,8,11,9,1,4,2,7,3,7
Metz,38,30,44,112,143,162,35,31,55,121,116,174
Atlantas,3,2,7,12,23,18,0,3,13,16,8,39
Stal Mielec,4,5,7,16,13,23,2,5,7,14,18,26
Flint Town U,5,1,10,16,15,20,5,1,9,15,22,36
Cadbury Heath,2,0,2,4,16,18,2,0,2,4,13,15
Bayern Alzenau,0,0,1,1,0,4,1,0,0,1,2,0
Internacional de Madrid,0,2,1,3,3,6,0,0,0,0,0,0
Netherlands,22,6,12,40,82,37,20,9,10,39,70,47
Shepton Mallet,2,0,0,2,3,1,0,0,3,3,6,13
Rigas FS,2,0,1,3,7,4,1,0,4,5,3,9
Uerdingen,0,0,1,1,0,2,0,1,0,1,0,0
Catania,9,2,8,19,32,29,2,3,10,15,9,23
Sanatate Cluj,0,0,1,1,1,6,0,0,0,0,0,0
Energiya Kh,2,5,9,16,13,24,0,4,12,16,3,31
B M'gladbach,81,31,41,153,295,183,64,40,61,165,254,238
Marijampole City,0,0,1,1,1,4,0,0,0,0,0,0
Puertollano,0,0,1,1,0,3,0,0,0,0,0,0
Halstead Town,0,1,0,1,3,3,0,0,0,0,0,0
Tonga,0,0,3,3,1,8,0,0,2,2,0,9
TSV Steinbach,1,1,2,4,4,5,0,1,1,2,2,4
Norway,18,9,9,36,51,33,12,6,16,34,45,50
Soham Town R,2,1,3,6,8,12,1,1,5,7,10,18
AFC W'bledon,73,51,73,197,265,257,51,63,81,195,205,270
Spain U21,12,2,0,14,39,6,7,3,2,12,24,11
Cuba,4,1,4,9,20,12,2,2,12,16,8,47
Hapoel Ash,6,12,14,32,22,38,5,8,22,35,25,58
Xanthi,40,35,27,102,115,87,22,31,51,104,87,147
Okzhetpes,0,1,5,6,6,11,0,1,4,5,0,11
Motagua,0,1,1,2,1,2,0,1,1,2,1,4
CA Bastia,3,3,5,11,10,14,3,2,6,11,11,21
Thun,46,35,40,121,194,185,30,32,61,123,158,219
Oleksandria,43,26,30,99,138,111,24,33,40,97,100,131
Spartans,42,10,17,69,146,72,35,12,24,71,134,103
VfR Aalen,1,4,2,7,6,7,0,1,4,5,2,9
Sarreguemines,4,2,1,7,10,9,1,0,2,3,4,7
Man Utd U23,2,0,0,2,4,2,0,1,2,3,2,6
Albion,45,30,73,148,173,246,44,32,69,145,189,250
Stade Brest,23,15,10,48,75,54,10,14,29,53,51,86
Lviv,8,14,23,45,38,75,13,10,22,45,37,73
SS Reyes,0,0,0,0,0,0,0,1,0,1,1,1
First Vienna,0,0,0,0,0,0,0,0,1,1,0,1
Bahrain,7,10,8,25,25,25,9,7,9,25,22,21
Bastia-Borgo,0,0,1,1,0,3,0,0,0,0,0,0
GFC Ajaccio,14,12,12,38,51,51,8,11,18,37,34,51
Jumilla,0,0,1,1,0,1,1,0,3,4,2,8
Leeds,84,43,52,179,251,186,69,35,81,185,238,265
Jarrow,0,2,1,3,2,4,0,0,0,0,0,0
Abingdon United,1,1,2,4,12,15,0,1,4,5,8,17
Red Star Paris,9,6,5,20,26,20,7,5,8,20,18,20
Farsley AFC,36,22,19,77,132,98,45,12,26,83,159,122
Bonnyrigg Rose,20,3,3,26,81,23,18,3,4,25,62,27
Staveley Miners,1,1,0,2,4,2,1,0,2,3,8,9
Epila,0,0,0,0,0,0,0,1,0,1,0,0
Billingham T,1,0,2,3,7,7,2,0,2,4,8,8
Korona Kielce,47,32,41,120,154,159,25,40,53,118,114,185
Halmstads,14,14,20,48,55,64,8,11,31,50,44,83
Martinique,5,2,2,9,17,7,5,1,5,11,15,15
Pinchbeck United,0,0,1,1,0,3,0,0,0,0,0,0
Eskilsminne IF ,0,0,2,2,0,9,0,0,1,1,1,4
Bosnia U21,0,0,0,0,0,0,0,0,2,2,0,7
Real Aviles,0,1,1,2,0,1,0,0,1,1,0,4
Doncaster,83,54,61,198,286,222,67,45,85,197,264,283
FK Trepca,0,0,1,1,0,8,0,0,0,0,0,0
Atletico Astorga,0,0,0,0,0,0,0,0,1,1,1,5
Loko. Tbilisi,3,0,2,5,5,9,1,0,2,3,3,4
Ciudad de Lucena,0,0,1,1,0,3,0,0,0,0,0,0
Buducnost P.,8,2,11,21,25,30,6,5,6,17,15,15
Inverkeithing BC,0,0,0,0,0,0,0,0,1,1,2,6
Frosinone,16,14,28,58,69,87,10,11,32,53,44,98
Bordeaux,76,43,43,162,234,181,47,46,74,167,181,232
Hoddesdon,1,1,0,2,2,0,1,0,4,5,8,13
Hallen,1,0,1,2,2,1,1,0,2,3,3,5
Holstein Kiel,33,23,19,75,127,91,28,24,25,77,140,114
FT Braunschweig,0,0,1,1,0,4,0,0,0,0,0,0
Ruzomberok,7,2,5,14,22,18,4,1,13,18,18,31
Hampton & R,71,38,55,164,256,218,64,38,51,153,246,215
Part. Bardejov,0,0,2,2,2,10,0,0,0,0,0,0
SV Darmstadt,39,31,37,107,144,141,36,25,53,114,152,186
Casarano,0,0,0,0,0,0,1,0,1,2,3,4
Stanway,2,1,1,4,4,6,6,2,3,11,17,17
Bodmin Town,5,0,2,7,15,10,3,0,4,7,11,12
Pontivy Stade,0,0,1,1,2,4,1,0,0,1,1,0
Ergotelis,7,6,14,27,34,46,8,5,12,25,22,35
Bressuire,1,0,2,3,2,5,0,0,0,0,0,0
Graham St P,0,0,0,0,0,0,0,0,1,1,2,7
Inter Baku,9,6,3,18,24,13,5,5,9,19,22,31
Saint-Lo,0,1,1,2,3,4,0,0,0,0,0,0
Chichester C,6,1,6,13,19,20,11,3,5,19,37,27
Arezzo,1,1,1,3,3,3,2,0,4,6,8,14
Chatham Town,0,1,3,4,2,6,4,2,4,10,15,20
Bohemians D.,54,32,39,125,178,136,48,26,52,126,143,150
Strasbourg,38,23,27,88,138,117,26,25,43,94,109,140
Lamia,17,29,20,66,54,74,11,23,30,64,43,87
Staines,41,20,64,125,188,259,33,28,67,128,177,273
NS Mura,26,20,10,56,93,54,18,18,18,54,68,60
Norwich U21,3,2,3,8,16,14,5,2,6,13,20,26
Pays Argentonnais,0,0,1,1,0,8,0,0,0,0,0,0
Pedroneras,0,0,0,0,0,0,0,0,1,1,1,2
FK Siauliai,2,0,0,2,5,1,1,0,1,2,2,3
Desborough T,2,0,1,3,19,11,2,0,2,4,8,8
Faetano,1,0,0,1,2,1,1,0,1,2,2,3
Worcester,34,26,27,87,136,111,24,21,40,85,84,124
Nimes II,1,0,0,1,2,0,0,0,0,0,0,0
Georgia Rustavi,1,0,0,1,2,0,0,1,1,2,3,6
Redcar Athletic,0,0,1,1,1,2,0,0,0,0,0,0
Stone Old Alleynians,1,0,0,1,3,2,0,0,1,1,2,3
Ashton Utd,76,32,48,156,260,218,57,40,56,153,243,242
Sektzia Nes Tziona,7,2,8,17,16,20,2,6,9,17,10,26
Monza,4,0,0,4,8,1,1,2,3,6,5,9
Haywards H'th T,6,0,3,9,15,11,1,1,3,5,3,15
Southampton U21,7,1,3,11,24,11,6,2,11,19,21,39
US Rumelange,2,0,3,5,7,16,0,1,7,8,7,20
P-sur-Moselle,0,0,2,2,1,5,0,0,0,0,0,0
Histon,20,17,29,66,90,115,10,10,42,62,69,142
Phoenix Sports,0,2,5,7,8,18,7,0,3,10,16,10
Mil-Mugan,0,0,0,0,0,0,0,0,1,1,0,7
Avranches,6,3,9,18,20,28,1,3,4,8,6,11
Le Puy Foot 43,4,1,1,6,11,4,1,4,1,6,6,9
Barton Rovers,1,1,1,3,5,4,2,0,5,7,12,18
Cottbus,0,3,2,5,7,12,0,0,1,1,0,1
Dunarea Calarasi,5,7,8,20,16,21,2,9,9,20,8,22
Deal Town,3,1,1,5,12,8,2,2,4,8,15,25
1860 Munich,18,9,18,45,58,58,7,10,23,40,33,60
Bath City,73,36,45,154,243,171,54,40,64,158,210,218
St Ives,14,13,25,52,61,91,14,8,31,53,60,111
AB Argir,0,0,2,2,1,6,0,1,2,3,2,10
Tarxien Rainbows,0,0,2,2,1,9,1,0,2,3,2,3
Beith Juniors,4,1,2,7,21,11,6,1,0,7,19,6
Iraq Olympic,0,1,0,1,0,0,0,2,0,2,1,1
Badajoz,3,3,1,7,9,6,1,1,3,5,2,6
Servette,15,14,7,36,58,39,11,7,17,35,42,59
Krupa na Vrbasu,1,3,1,5,5,6,0,1,1,2,1,5
Olimpia,1,0,0,1,6,0,0,0,0,0,0,0
Hartley Wint.,19,10,16,45,79,70,19,14,19,52,79,81
Urawa Red Diamonds,0,0,0,0,0,0,1,0,0,1,3,2
Manchester 62,0,1,1,2,0,3,0,0,0,0,0,0
Reus Deportiu,21,25,25,71,59,59,18,15,38,71,42,76
Partizan,119,29,16,164,360,120,90,34,41,165,285,159
SV Atlas Delmenhorst,0,0,1,1,1,6,0,0,0,0,0,0
Maceratese,0,0,0,0,0,0,0,1,1,2,6,7
Bergmann Borsig,0,0,0,0,0,0,0,0,1,1,0,3
Kayserispor,36,36,40,112,126,144,25,27,61,113,116,212
India,5,2,10,17,23,30,1,4,8,13,10,21
St Brieuc,0,0,0,0,0,0,0,0,1,1,0,2
KTP Kotka,5,6,7,18,17,22,2,8,9,19,13,27
Heybridge,7,0,2,9,31,13,6,6,5,17,28,24
Girona,77,46,43,166,225,151,57,47,63,167,197,214
W Ham U23,1,2,0,3,5,3,3,1,3,7,10,10
Astana,60,13,13,86,189,78,31,21,32,84,100,114
Yeovil,70,56,72,198,250,251,42,46,95,183,200,305
Campodarsego,0,1,0,1,4,4,0,0,1,1,0,1
Botev Vratsa,16,11,20,47,54,52,12,9,26,47,53,84
Panegialios,0,0,1,1,0,4,0,0,0,0,0,0
St. Truiden,47,28,34,109,160,131,25,30,56,111,118,190
PS Kemi,13,12,23,48,54,74,11,7,33,51,43,92
Leotar,0,0,2,2,0,6,0,0,0,0,0,0
Luxembourg,10,7,21,38,34,62,5,5,18,28,23,62
Angers,51,36,43,130,167,144,36,32,57,125,123,176
Odd Down,4,0,2,6,13,13,0,1,3,4,6,9
Wacker Nord,0,1,1,2,1,4,0,0,0,0,0,0
Sarajevo,18,3,10,31,52,36,18,6,11,35,58,42
Liefering,1,0,0,1,4,1,1,0,0,1,4,0
Barnsley,83,58,55,196,288,236,68,36,89,193,244,279
Ashton Athletic,3,0,0,3,9,2,0,0,2,2,0,4
Horsham,18,5,7,30,58,29,10,4,14,28,35,52
Saint-Quentin,0,0,1,1,1,2,0,1,0,1,0,0
Chile,28,9,8,45,90,47,12,12,20,44,49,54
Pyunik Yerevan,11,4,7,22,30,33,7,6,10,23,31,44
Middlesbrough U21,4,0,2,6,16,13,5,3,9,17,21,31
Istres,0,0,3,3,2,10,0,1,1,2,1,2
Barton T OB,1,0,1,2,8,2,1,0,1,2,6,6
Wycombe,82,45,66,193,249,239,69,53,69,191,238,240
FC Nottingen,0,0,2,2,3,8,0,0,0,0,0,0
E Frankfurt,73,43,36,152,263,192,54,33,73,160,214,262
Spalding Utd,0,0,4,4,3,9,1,2,4,7,16,20
Evergreen,0,0,1,1,0,4,0,0,0,0,0,0
N Forest U23,0,0,0,0,0,0,0,1,1,2,2,9
Mestre,0,0,0,0,0,0,0,1,0,1,2,2
Billericay,87,35,46,168,330,217,55,44,61,160,236,250
Metalurg S.,1,1,3,5,4,5,5,1,4,10,15,13
Newmarket,0,0,1,1,0,1,0,0,2,2,2,9
FC Broxbourne Borough,1,0,1,2,4,4,2,0,1,3,6,8
Bravo Publikum,14,10,10,34,39,32,8,14,13,35,46,56
FC Ufa,36,31,41,108,114,116,20,41,49,110,71,133
Andorra CF,0,0,1,1,0,5,0,0,0,0,0,0
Osasuna II,0,0,0,0,0,0,0,1,0,1,0,0
NK Krsko,19,22,31,72,69,95,13,20,39,72,59,129
Mainz II,0,1,2,3,1,5,0,0,0,0,0,0
CSKA 1948 Sofia,8,3,3,14,24,13,2,5,6,13,10,20
Stade Briochin,0,1,1,2,1,2,2,2,0,4,5,3
Tooting Bec,0,0,1,1,2,3,0,0,0,0,0,0
Vik Cologne,0,0,1,1,2,4,0,0,0,0,0,0
Mayo League,0,0,0,0,0,0,0,0,2,2,3,6
San Carlos,0,0,1,1,3,5,0,0,1,1,0,1
Shanghai Sh,0,0,0,0,0,0,0,0,1,1,0,3
Kyrgyzstan,8,2,4,14,28,13,5,3,13,21,17,47
Tamworth,50,27,28,105,178,139,26,26,55,107,127,198
Korea Republic Olympic,1,0,1,2,1,1,1,1,0,2,11,3
Sabah FK,0,0,2,2,0,3,0,2,3,5,1,8
Porto,136,20,20,176,409,126,97,46,36,179,308,162
Guastatoya,0,0,1,1,0,1,0,0,1,1,1,2
Huracan,0,0,1,1,1,2,0,0,0,0,0,0
Clapton,2,0,1,3,5,6,0,0,1,1,2,3
Real Esteli,0,0,1,1,0,4,0,0,3,3,0,7
Varmamo,0,0,1,1,0,2,0,0,0,0,0,0
Japan Women,1,1,2,4,3,7,0,2,2,4,4,7
Colomiers,0,2,1,3,3,4,0,0,2,2,1,5
Lille,81,46,37,164,236,141,64,37,70,171,202,225
Newtown,45,30,41,116,207,187,41,20,63,124,166,217
Engordany,2,0,4,6,5,9,1,1,2,4,2,13
Fylkir,0,1,4,5,1,8,1,1,2,4,5,4
Guildford City,0,1,0,1,1,1,2,0,1,3,9,8
Bridport,0,0,1,1,0,6,1,0,2,3,2,7
Sollentuna FK,0,0,2,2,1,10,0,0,1,1,0,4
Peterborough Sports,6,1,3,10,27,19,5,0,4,9,19,16
San Jose,40,28,24,92,144,124,17,19,59,95,104,194
Saltdean United,1,1,1,3,5,5,0,0,1,1,1,2
Egypt,29,2,6,37,56,15,6,7,12,25,25,30
Portishead Town,0,0,1,1,1,3,0,0,0,0,0,0
Basford United,34,5,11,50,114,63,16,10,21,47,66,73
Forest Green,84,53,53,190,288,217,82,51,65,198,278,250
Vereya Stara,16,13,23,52,45,70,8,9,36,53,29,114
Zaqatala,0,0,0,0,0,0,0,1,0,1,2,2
Gyori ETO,10,6,6,22,40,30,11,4,8,23,33,30
Rapid Vienna,82,35,37,154,280,162,65,36,51,152,264,221
Nuremberg II,0,0,1,1,0,2,0,0,0,0,0,0
Oxford C,64,42,53,159,257,235,54,29,72,155,243,264
Brighouse Town,0,0,2,2,0,3,2,0,7,9,12,26
Swindon,77,37,78,192,262,268,63,43,82,188,251,295
Neustrelitz,0,0,0,0,0,0,0,0,1,1,0,2
Atherton L R,0,0,1,1,0,3,0,0,0,0,0,0
Odu Trencin,5,1,0,6,13,1,2,2,2,6,8,9
Thetford T,1,1,1,3,4,6,1,0,1,2,2,2
Murata,0,0,0,0,0,0,1,0,0,1,3,1
Tottenham,131,30,41,202,421,191,86,54,65,205,341,265
Feirense,15,11,26,52,53,78,11,11,31,53,39,83
Avangard Kursk,1,0,1,2,1,2,0,0,0,0,0,0
Alsager,2,1,2,5,12,10,0,1,1,2,3,4
Greuther Furth,49,24,34,107,152,137,29,39,44,112,140,169
Gaziantepspor,17,11,31,59,53,86,14,14,33,61,56,106
Zamora,2,0,2,4,5,7,0,0,2,2,4,6
Hall Road Rangers,1,0,1,2,6,6,2,0,0,2,5,3
Troyes II,0,1,0,1,1,1,0,0,0,0,0,0
Malaysia,4,4,8,16,21,30,4,1,10,15,14,42
Kortrijk,60,32,49,141,240,197,47,27,64,138,174,211
Nelson,0,0,1,1,0,5,0,0,0,0,0,0
Orihuela,0,1,1,2,1,2,0,1,2,3,0,3
Napoli,130,40,28,198,432,192,94,40,55,189,312,214
Wroxham,4,1,2,7,18,12,2,0,3,5,11,13
Bromsgrove S,5,2,2,9,21,17,5,1,4,10,21,11
Cyprus,8,6,13,27,32,36,6,2,23,31,24,61
Elgin City,71,30,52,153,277,218,49,24,81,154,221,289
Cannes,2,1,1,4,3,3,0,0,0,0,0,0
Denmark Olympic,1,0,1,2,1,4,0,1,1,2,0,2
Tallinna Kalev,0,0,0,0,0,0,0,0,1,1,0,9
Hungary U21,0,1,3,4,4,11,0,1,1,2,2,7
Regensburg,31,19,24,74,110,107,17,26,28,71,97,119
Niger Women,0,0,0,0,0,0,0,0,1,1,0,15
Sutjeska,8,6,7,21,25,19,7,6,9,22,20,25
Brechin,37,36,73,146,170,265,36,21,92,149,165,299
Dnepr Mogilev,7,14,25,46,34,68,5,15,27,47,30,75
Stade Poitevin,0,0,0,0,0,0,0,1,0,1,1,1
Fisher,1,1,1,3,7,5,0,2,1,3,4,5
Newcastle B,7,1,3,11,25,14,3,1,5,9,14,17
Berkhamsted,6,0,2,8,28,12,4,0,5,9,17,19
Pollok,0,0,1,1,1,2,0,0,0,0,0,0
Causeway Utd,0,0,1,1,1,5,0,0,1,1,0,1
Znojmo,2,3,2,7,9,8,0,1,6,7,5,18
Babelsberg,0,0,1,1,0,4,0,0,0,0,0,0
Livorno,4,5,13,22,27,40,1,3,13,17,14,43
Loko Skopje,0,0,1,1,1,4,0,0,0,0,0,0
Ashford (Mdx),2,3,4,9,14,17,4,3,2,9,17,20
IF Fuglafjordur,0,4,4,8,7,17,1,1,5,7,4,13
Stuttgart,62,25,46,133,206,177,39,32,69,140,179,250
Vannes,0,2,1,3,5,6,0,0,0,0,0,0
Galatasaray,96,33,23,152,325,142,63,33,54,150,216,209
Port Vale,85,46,68,199,274,246,45,51,95,191,185,290
Dynamo Kiev,98,31,25,154,300,122,89,32,31,152,276,150
Scarborough,0,0,1,1,0,2,0,0,0,0,0,0
C Franciscain,3,0,0,3,7,1,2,1,2,5,6,12
Angers SCO II,0,1,0,1,1,1,0,0,0,0,0,0
Drochtersen/A,0,0,3,3,0,7,0,0,0,0,0,0
Peterborough,101,45,58,204,361,253,73,44,82,199,285,281
NEC Nijmegen,18,10,14,42,57,59,6,13,23,42,37,76
Hollands and B,0,0,1,1,0,1,0,0,1,1,0,2
Chinese Taipei,3,1,9,13,13,24,1,0,7,8,9,39
RAEC Mons B,2,1,2,5,8,10,1,0,6,7,5,16
Penafiel,3,3,11,17,18,38,1,4,11,16,11,32
Taunton Town,33,16,8,57,138,84,22,11,19,52,76,78
Derby U23,2,0,4,6,10,13,0,1,4,5,4,13
South Africa,16,19,10,45,54,43,11,12,6,29,40,25
Eibar,58,37,56,151,195,173,37,46,74,157,161,244
Olbia,0,0,0,0,0,0,0,0,1,1,0,4
Westella & Willerby,0,0,1,1,1,5,0,0,0,0,0,0
Sheffield FC,1,0,3,4,6,8,1,0,3,4,6,9
Breno,0,0,0,0,0,0,0,0,1,1,0,2
Alloa,56,34,69,159,209,229,49,40,76,165,206,276
NK Varazdin,9,10,16,35,33,53,6,8,20,34,22,52
Molesey,3,0,2,5,10,8,1,0,2,3,5,8
Grosseto,0,0,0,0,0,0,0,0,1,1,2,5
Gateshead FC,0,0,0,0,0,0,1,0,0,1,2,1
Famalicao,10,14,10,34,45,51,12,9,13,34,46,50
Abbey Hulton United,0,0,0,0,0,0,0,1,1,2,3,4
Inverness CT U20,0,0,1,1,0,3,0,0,2,2,1,6
Chieri,0,0,0,0,0,0,0,0,1,1,1,2
IFK Goth'burg,56,35,29,120,198,125,41,38,39,118,164,161
Ashford United,2,2,3,7,8,15,5,2,3,10,27,16
Ilfracombe T,0,0,0,0,0,0,0,0,1,1,0,4
ND HIT Gorica,43,30,47,120,149,154,32,26,59,117,125,173
Canterbury City,8,1,1,10,23,15,2,0,4,6,12,11
Massese,0,0,0,0,0,0,0,0,1,1,0,1
Al Nassr,0,0,1,1,1,2,0,0,0,0,0,0
Seville II,1,2,0,3,5,4,1,0,0,1,3,0
FSV Zwickau,1,0,2,3,4,5,0,0,2,2,2,4
Bristol C,85,49,62,196,288,226,71,48,74,193,259,274
NK Siroki Brijeg,6,3,5,14,17,14,4,5,5,14,14,12
Sestao,1,1,2,4,5,9,0,0,2,2,0,2
Paulhan Pezenas,0,0,1,1,0,2,0,0,0,0,0,0
Wormatia Worms,0,0,1,1,1,6,0,0,0,0,0,0
Iran,26,9,4,39,90,23,18,8,7,33,43,20
Spelthorne Sports,1,0,2,3,3,4,0,0,1,1,1,2
Bregalnica S,1,1,0,2,9,5,0,0,0,0,0,0
Hodd,0,0,1,1,0,2,0,0,0,0,0,0
Arouca,23,13,24,60,70,75,11,20,32,63,56,99
Penybont,9,7,12,28,37,44,9,6,13,28,34,42
Leioa,3,0,1,4,5,7,0,1,4,5,4,13
Thornbury Town,0,0,1,1,1,5,1,0,0,1,4,0
Senica,2,0,5,7,5,17,0,0,7,7,6,24
Valmiera,0,0,0,0,0,0,0,2,3,5,3,10
Togo,8,7,6,21,32,22,1,6,13,20,11,33
Christchurch,6,1,2,9,17,10,0,1,0,1,1,1
Becerril,1,0,1,2,1,8,0,0,0,0,0,0
Bury Town,11,10,21,42,41,63,10,8,29,47,45,89
Akhisar B,36,30,32,98,129,123,22,24,52,98,112,170
Stourbridge,65,30,31,126,227,151,50,27,47,124,195,184
Argentina,31,10,9,50,93,36,21,11,6,38,70,36
Serbia,16,9,9,34,65,46,16,12,11,39,46,43
Longueau,0,1,1,2,1,3,0,0,0,0,0,0
Rodange,0,0,0,0,0,0,0,0,3,3,1,15
Hong Kong,7,4,4,15,25,15,2,6,4,12,8,13
Garforth Town,1,1,0,2,3,2,0,0,2,2,2,9
Carquefou,0,0,0,0,0,0,0,0,1,1,0,2
Rukh Brest,10,8,6,24,38,27,9,8,4,21,44,26
Neusiedl,1,0,0,1,1,0,0,0,0,0,0,0
Wimborne T,22,10,13,45,77,65,12,7,33,52,65,111
Buxton,69,38,49,156,286,216,53,42,55,150,208,212
Real Madrid,154,33,28,215,556,200,130,41,39,210,445,217
Palmeiras,0,0,1,1,0,1,0,1,0,1,0,0
Hermannstadt,19,18,20,57,63,67,10,18,30,58,47,87
Rakow Czestochowa,20,6,8,34,49,31,12,7,13,32,45,49
Belarus,10,8,9,27,34,29,14,7,23,44,43,77
Mangotsfield,5,0,5,10,25,20,1,1,2,4,4,4
Codru Lozova,0,0,1,1,0,2,0,0,0,0,0,0
Camelon Juniors,0,0,1,1,1,2,0,0,0,0,0,0
Georgia,15,8,11,34,47,30,7,10,17,34,35,51
FC Mika,1,2,1,4,4,4,3,0,3,6,9,11
Valencia II,2,1,1,4,6,2,0,1,2,3,2,5
AFC Kempston R,2,1,2,5,6,4,2,1,5,8,12,17
Coldstream,0,0,0,0,0,0,1,0,4,5,5,15
Angola,11,4,6,21,28,19,4,11,10,25,15,27
Brazil Women,1,0,1,2,3,1,1,0,5,6,6,10
Paris St-G.,160,26,18,204,562,134,148,30,34,212,473,193
Teteks,0,0,1,1,1,2,0,0,0,0,0,0
Haskovo,4,1,11,16,13,32,0,2,13,15,5,37
Fraserburgh,39,5,16,60,203,70,41,9,12,62,157,76
Juventus Buch,2,5,13,20,11,37,2,5,13,20,10,35
Cherno More,58,31,38,127,151,125,36,31,57,124,141,175
Fylde,101,43,28,172,372,188,76,42,53,171,291,227
AS P-l-Mezieres,3,0,1,4,6,3,1,2,3,6,7,7
Dnyapro,8,2,7,17,22,19,1,4,12,17,13,32
M. Petah Tikva,37,35,39,111,121,121,42,25,44,111,119,145
FC Marek,3,5,8,16,12,26,2,0,14,16,3,45
Windsor,2,0,2,4,7,13,7,0,3,10,22,18
Durham City,0,0,1,1,0,1,0,0,0,0,0,0
Charlton,78,58,60,196,268,225,63,51,83,197,231,277
Burnham,7,8,22,37,41,72,3,4,28,35,32,85
Backa Palanka,28,12,33,73,86,98,4,14,56,74,36,138
Lossiemouth,7,3,46,56,60,188,4,5,43,52,43,195
Team Wellington,0,0,0,0,0,0,0,1,0,1,3,3
Kuwait,6,7,10,23,40,31,6,6,9,21,17,27
Sable,0,1,1,2,3,6,0,0,0,0,0,0
Connah's Q,75,27,29,131,227,130,58,25,44,127,201,149
Gimnastic,34,30,29,93,116,112,22,24,44,90,80,122
Singapore,7,3,9,19,28,37,4,3,9,16,13,21
Tower Hamlets,0,0,1,1,1,2,0,1,1,2,4,7
Curacao,11,5,4,20,45,13,5,4,5,14,23,18
Monaco II,1,0,0,1,3,2,0,0,0,0,0,0
Galicia,0,1,0,1,1,1,0,0,0,0,0,0
Burscough,2,1,2,5,6,5,2,1,3,6,9,10
Somozas,1,0,0,1,3,0,1,0,1,2,2,5
Sambenedettese,2,1,0,3,4,1,0,1,3,4,7,10
Riga FC,9,3,3,15,24,9,7,2,3,12,28,14
Schalding-Heining,0,0,0,0,0,0,0,0,1,1,1,3
Loko Gorna,5,4,7,16,16,19,2,5,9,16,16,32
Hailsham Town,0,0,1,1,1,4,1,0,1,2,2,7
F91 Dudelange,29,11,12,52,121,71,24,7,19,50,98,75
Inverness CT,71,53,40,164,252,179,64,40,65,169,219,241
Gernika,1,0,0,1,1,0,0,0,1,1,0,1
West Ham,74,36,53,163,249,215,48,42,79,169,206,271
Orebro,44,29,36,109,165,165,31,24,54,109,130,185
Romford,1,1,2,4,4,8,2,1,3,6,10,13
Niger,7,4,4,15,22,16,1,3,12,16,6,23
Stoke U21,3,1,2,6,13,11,3,3,12,18,13,35
Airdrieonians,64,30,55,149,221,182,56,28,62,146,195,227
AIK Solna,78,27,22,127,216,105,55,37,33,125,177,134
Aubagne,0,3,1,4,5,7,2,1,1,4,8,4
R Volgograd,3,2,10,15,5,23,2,4,8,14,9,28
Las Palmas,77,44,44,165,248,187,34,51,82,167,162,273
Qatar,28,13,12,53,99,44,14,7,14,35,44,46
Wolves U21,4,0,4,8,14,14,5,6,10,21,28,38
Olot,2,1,1,4,5,6,2,2,2,6,8,10
Westside,0,0,1,1,3,4,0,0,0,0,0,0
Sintra,0,1,0,1,1,1,0,0,0,0,0,0
Challans,0,0,1,1,0,1,1,0,1,2,3,4
Hapoel Acre,16,15,28,59,54,80,13,14,32,59,45,98
Tranent Juniors,3,1,0,4,14,6,1,1,1,3,3,6
Barnsley U21,0,0,1,1,1,3,0,0,1,1,1,7
Utenis Utena,2,0,1,3,2,3,0,1,3,4,3,9
NK Zagreb,10,8,18,36,43,55,6,7,23,36,29,63
Triestina,1,0,0,1,3,1,3,1,3,7,12,15
Freiburger,0,0,1,1,0,5,0,0,0,0,0,0
Kalev Sillamae,3,1,4,8,15,16,3,1,7,11,21,35
Catanzaro,3,0,0,3,8,2,0,2,3,5,4,8
Wolves,95,46,45,186,284,190,75,47,62,184,237,219
AD Union Adarve,0,0,0,0,0,0,1,2,1,4,2,5
Sudtirol,4,0,0,4,11,6,4,0,8,12,12,21
Hook Norton,0,0,1,1,0,2,0,0,0,0,0,0
Sochi,16,7,7,30,59,28,8,9,13,30,32,45
Caernarfon,21,10,16,47,74,67,13,9,22,44,51,88
Highmoor Ibis,0,0,1,1,0,1,0,0,2,2,2,5
Nuneaton Griff,1,1,2,4,3,7,4,0,1,5,15,11
Tsarsko Selo,9,8,12,29,34,42,9,4,17,30,25,40
Sturm Graz,60,28,45,133,213,175,52,30,53,135,173,170
Levanger,0,0,1,1,2,4,0,0,0,0,0,0
Haverhill Borough,0,0,1,1,3,4,0,0,2,2,2,9
Kendal Town,5,0,2,7,14,10,2,0,5,7,7,16
Royal Knokke,0,0,0,0,0,0,1,0,0,1,2,1
Tulevik Viljandi,1,0,1,2,1,2,0,0,4,4,1,13
Kalmar,36,35,39,110,132,135,27,26,57,110,107,180
Lithuania U21,0,1,0,1,0,0,0,0,0,0,0,0
SP Domagnano,0,0,1,1,2,3,0,0,0,0,0,0
Marlow,5,2,1,8,13,7,2,0,7,9,16,33
La Suze,0,0,2,2,2,8,0,0,0,0,0,0
TP Mazembe,0,0,1,1,0,3,0,0,1,1,1,2
Man City U23,1,1,0,2,3,2,2,0,1,3,9,7
Nottm Forest,80,42,64,186,258,221,45,62,84,191,205,276
Kaisar Kyzylorda,0,2,4,6,7,15,0,0,6,6,2,16
Kansas City,56,26,20,102,191,119,26,26,46,98,107,142
Stal Dniprodzerzhynsk,11,11,23,45,42,54,12,14,19,45,30,52
Farnham Town,1,1,1,3,7,6,0,0,2,2,3,9
Gloucester,53,38,56,147,205,201,46,35,64,145,191,252
Portsmouth,106,51,49,206,341,199,83,47,70,200,271,256
Eastbourne U,3,0,3,6,13,10,0,1,0,1,2,2
Spartak Trnava,27,5,11,43,80,36,15,11,19,45,60,56
Hinchesti,0,1,0,1,1,1,0,0,1,1,1,2
Grenoble,1,5,5,11,7,13,3,5,2,10,9,7
Cowes Sport,0,0,0,0,0,0,0,0,2,2,0,4
Loxwood,1,0,0,1,3,1,1,0,2,3,5,7
Cray W,16,12,14,42,88,68,20,4,16,40,59,73
Pt Talbot,16,9,14,39,60,53,12,7,20,39,59,88
Seattle,68,18,19,105,195,91,30,25,48,103,118,154
Shirak Gumri,7,2,6,15,18,15,5,2,9,16,26,33
Jeunesse Canach,1,0,1,2,4,5,0,1,3,4,4,11
Gozzano,0,0,0,0,0,0,0,1,0,1,0,0
Poblense,0,0,2,2,2,6,0,0,0,0,0,0
Basildon United,3,1,2,6,19,17,3,2,3,8,10,15
CFR Cluj,87,43,25,155,241,99,72,42,40,154,202,141
Chalfont St P,3,2,4,9,15,13,2,3,2,7,9,11
Birmingham,62,47,80,189,223,268,47,58,78,183,182,259
Colombia Women,0,0,0,0,0,0,1,1,0,2,3,1
Deportivo Galicia,0,0,1,1,1,2,0,0,0,0,0,0
St Clements D,0,0,1,1,0,2,0,0,0,0,0,0
Vizela,0,0,1,1,1,2,0,0,0,0,0,0
Nomme Kalju,15,5,9,29,53,32,10,7,11,28,41,35
Desp. Aves,14,7,30,51,49,73,10,8,33,51,46,95
Sheff Utd U23,0,1,0,1,3,3,1,0,1,2,1,4
Leatherhead,69,28,44,141,217,170,52,30,61,143,205,228
Gent,97,35,37,169,311,178,59,47,60,166,226,214
Differdange 03,13,2,5,20,45,27,9,1,9,19,32,22
Avoine OCC,0,1,0,1,1,1,0,0,0,0,0,0
Oeffingen,0,0,1,1,2,5,0,0,0,0,0,0
Estonia,11,8,16,35,40,46,12,12,25,49,32,80
Tuzla City,1,3,2,6,5,6,0,0,7,7,2,14
Gomel,23,20,37,80,83,96,19,18,41,78,69,107
Horley Town,2,0,3,5,14,14,4,1,3,8,16,14
Mexico Olympic,0,1,0,1,2,2,1,0,1,2,5,2
Portugal U21,6,2,3,11,20,11,6,4,1,11,21,8
Anderlecht,93,46,29,168,293,150,62,42,64,168,232,242
Ath Bilbao,96,47,44,187,298,182,61,55,76,192,219,246
Borrowash Vics,1,0,1,2,2,6,0,1,0,1,3,3
Neubrandenburg,0,0,1,1,1,3,0,0,0,0,0,0
Tolosa,1,0,1,2,1,3,0,0,0,0,0,0
Crawley Green,1,0,1,2,4,2,0,0,4,4,4,12
Rielasingen-A,0,0,2,2,1,11,0,0,0,0,0,0
Faroe Islands,7,5,11,23,21,41,5,5,19,29,21,57
Worthing,40,28,30,98,179,159,46,17,38,101,167,165
Dukla Pribram,38,21,41,100,132,152,13,23,67,103,73,213
Jamaica Women,0,0,2,2,1,9,0,0,2,2,2,6
FK Raca,0,0,1,1,0,9,0,0,0,0,0,0
Slimbridge,0,1,6,7,4,13,2,1,1,4,10,8
Kings Lynn (old),0,0,1,1,0,1,0,1,0,1,3,3
Northampton S,0,1,0,1,0,0,0,1,2,3,3,9
Lobon,0,0,0,0,0,0,0,0,1,1,0,2
El Ejido,0,0,0,0,0,0,0,0,2,2,0,5
Mansfield,73,62,59,194,274,224,61,59,72,192,207,248
M. Netanya,35,25,43,103,131,141,31,28,43,102,111,145
Newport P T,6,0,1,7,19,12,4,0,4,8,14,19
Forres Mech,33,8,18,59,144,89,30,9,19,58,130,92
Emmaste,0,0,1,1,2,7,0,0,0,0,0,0
Siena,1,1,2,4,3,6,1,0,2,3,5,6
FK Sevojno,1,1,5,7,3,11,1,2,4,7,4,8
Gretna 2008,15,8,29,52,69,109,16,6,35,57,82,140
York,63,52,47,162,211,188,47,44,70,161,207,245
Vendsyssel,3,6,7,16,17,21,3,5,8,16,15,28
Marathon,0,1,1,2,4,8,0,0,2,2,0,10
Buchbach,0,0,1,1,0,4,0,0,0,0,0,0
Bewdley Town,0,1,0,1,2,2,0,0,2,2,1,5
Belchatow,5,6,8,19,19,30,4,3,12,19,17,36
Mezokovesd SE,37,17,34,88,120,108,20,31,40,91,88,138
US Granvillaise,6,2,3,11,17,13,2,1,4,7,10,12
Guadalajara,3,0,2,5,10,4,2,3,2,7,8,9
Balham,0,0,1,1,1,3,0,0,0,0,0,0
Devizes Town,0,0,1,1,0,3,0,0,0,0,0,0
Ebreichsdorf,0,1,1,2,0,5,0,0,0,0,0,0
Maidstone,79,40,55,174,267,223,63,38,68,169,217,239
Rudar Pljevlja,3,0,4,7,9,8,1,4,2,7,4,8
Stirling,53,35,65,153,196,220,51,33,66,150,211,236
Atherton Colls,14,3,11,28,52,45,10,4,14,28,48,45
Milton Keynes Robins,0,0,1,1,1,6,1,0,0,1,2,0
Altay Izmir,0,0,1,1,1,2,0,0,0,0,0,0
NK Inter,22,29,39,90,103,139,17,20,53,90,77,186
Panama Women,0,1,0,1,1,1,0,0,0,0,0,0
Garstang,0,0,1,1,2,6,0,1,0,1,1,1
Amiens,24,15,26,65,82,87,9,17,35,61,43,99
Ventspils,14,5,9,28,49,27,4,7,12,23,25,40
Flackwell Heath,1,0,3,4,7,12,7,1,4,12,31,20
Domzale,73,39,33,145,261,144,59,38,48,145,208,175
Jedinstvo,0,0,0,0,0,0,0,0,2,2,3,10
Bremer SV,0,0,3,3,0,11,0,0,0,0,0,0
Tallinna FC Infonet,5,3,3,11,30,20,4,0,5,9,12,13
St Blazey,1,1,0,2,6,3,0,0,1,1,2,5
Nest-Sotra,0,0,1,1,0,2,0,0,0,0,0,0
Trafford,7,8,21,36,48,67,13,11,18,42,63,77
Latina,2,2,2,6,7,9,1,2,4,7,7,10
W Mannheim,1,0,2,3,6,8,0,0,0,0,0,0
Cittadella,13,10,5,28,58,35,8,6,6,20,23,20
Dinamo Vranje,7,2,10,19,17,28,2,4,14,20,7,46
Gala Fairydean,22,6,31,59,97,112,16,13,25,54,79,112
Belshina,17,14,31,62,82,102,18,17,27,62,84,99
Merida,1,0,0,1,2,1,0,0,0,0,0,0
Ararat-Armenia,8,0,4,12,21,16,6,0,3,9,13,10
Erzurum B,8,11,18,37,36,50,9,10,17,36,41,59
Pelister Bitola,2,0,5,7,7,12,0,3,5,8,5,20
Rangers U20,4,0,2,6,12,7,3,1,2,6,10,8
Hertha II,0,1,0,1,0,0,1,0,0,1,2,0
Hibernian U20,1,0,2,3,8,6,0,1,1,2,3,5
Norrkoping,74,21,21,116,234,123,48,32,34,114,167,154
Willenhall,0,0,0,0,0,0,1,0,1,2,2,2
Rudar Prijedor,0,1,0,1,1,1,0,0,0,0,0,0
Stevenage,75,50,70,195,271,248,45,54,88,187,175,261
Nimes,21,17,26,64,83,85,15,14,35,64,73,123
Wivenhoe Town,0,0,0,0,0,0,0,0,2,2,1,8
BFC Daugavpils,0,0,2,2,0,2,1,0,7,8,3,20
C. Budejovice,17,10,20,47,54,70,10,12,24,46,54,93
Sautron,0,0,1,1,0,1,0,0,0,0,0,0
St Joseph's,3,3,6,12,17,20,4,3,5,12,13,21
Nairn County,29,7,25,61,111,108,17,6,27,50,75,111
Bishop Auck,1,0,4,5,7,11,1,0,1,2,1,2
Tobol,4,5,4,13,13,13,1,2,5,8,5,12
Corinthian,6,1,3,10,27,24,4,1,2,7,14,11
Luch Minsk,3,6,6,15,15,21,1,6,8,15,9,23
Makedonija,0,0,2,2,0,4,0,0,2,2,1,9
Holwell Sports,0,0,1,1,0,2,0,0,0,0,0,0
Paris Atletico,1,0,0,1,1,0,0,0,0,0,0,0
Gr Yarmouth T,2,0,1,3,6,4,1,0,3,4,4,6
Llapi,0,0,1,1,1,3,1,0,1,2,3,9
Maldon & T,22,2,6,30,95,42,10,1,3,14,28,16
St Panteleimon,0,0,1,1,1,3,0,0,0,0,0,0
Nicaragua,7,2,8,17,27,21,6,5,14,25,28,39
AG Caennaise,0,0,1,1,0,1,0,0,0,0,0,0
Excelsior,23,24,38,85,117,153,19,22,44,85,94,165
Newhaven,3,1,2,6,12,10,4,0,2,6,13,5
Vysocina Jihlava,25,18,25,68,88,82,13,14,40,67,57,127
Stapenhill,0,0,0,0,0,0,0,1,0,1,2,2
R. Vallecano,71,41,48,160,236,196,41,46,72,159,176,263
Brightlingsea R,24,16,32,72,84,108,18,17,41,76,94,151
Finn Harps,52,20,44,116,142,134,31,30,54,115,107,176
Holbeach,3,0,1,4,8,6,5,0,5,10,17,20
Isidro Metapan,0,0,1,1,2,4,0,0,2,2,1,8
Rijeka,104,33,19,156,328,121,77,37,46,160,241,176
WIT Georgia,0,1,0,1,0,0,0,0,1,1,0,3
Roda JC,15,17,27,59,62,87,11,14,35,60,55,117
GS Consolat,3,2,2,7,11,9,2,0,6,8,9,15
Pena Sport,0,0,2,2,1,3,1,0,1,2,5,3
Cammel Laird,0,0,0,0,0,0,0,0,1,1,0,5
Spain,31,5,5,41,120,27,20,13,7,40,67,35
Druids,0,1,0,1,1,1,0,0,1,1,0,1
FK Indija,13,4,17,34,33,47,4,5,24,33,22,62
Nuneaton,42,33,50,125,156,172,35,26,66,127,161,230
RoPS,48,23,39,110,138,114,32,27,53,112,118,168
Crowborough,3,1,2,6,17,12,3,0,2,5,10,9
Maltby Main,1,0,0,1,3,1,1,0,2,3,8,9
Eastleigh,83,53,43,179,275,198,66,46,75,187,252,288
Droitwich Spa,1,0,0,1,2,0,0,0,1,1,1,2
Nyiregyhaza,4,5,6,15,19,18,4,1,10,15,14,31
Cyprus U21,0,0,1,1,0,3,0,0,0,0,0,0
Yemen,2,4,7,13,10,23,1,5,10,16,6,27
Apoel Nicosia,55,19,21,95,181,83,36,22,33,91,131,99
Kairat Almaty,24,4,4,32,76,21,17,6,13,36,51,39
Ireland Women,0,0,0,0,0,0,0,0,1,1,1,2
Genoa,61,38,53,152,219,194,29,40,79,148,145,250
Chinato,0,0,0,0,0,0,0,0,1,1,0,3
Southall,4,1,2,7,22,14,6,0,4,10,23,18
Spezia,17,9,13,39,53,44,10,10,20,40,48,71
Viking,40,22,30,92,158,126,29,21,40,90,115,145
Virgin Isl. (UK),0,0,2,2,2,6,0,1,2,3,0,7
Chesham,79,34,42,155,293,193,61,35,62,158,228,237
V sur Saone,0,0,1,1,0,9,0,0,0,0,0,0
Wycombe W,0,0,0,0,0,0,1,0,0,1,3,0
Ipswich W,3,1,0,4,5,2,2,0,4,6,9,12
King's Lynn,74,33,42,149,245,175,50,35,64,149,206,261
Gefle,15,13,17,45,54,56,9,10,26,45,49,93
FK Suduva,15,9,7,31,46,23,11,4,12,27,36,34
Atletico Pantoja,0,0,2,2,0,5,0,0,2,2,1,6
Hartberg,17,15,17,49,64,76,16,9,24,49,77,119
Beaconsfield,15,14,18,47,74,79,10,11,27,48,38,85
Bordeaux II,0,0,0,0,0,0,0,0,1,1,0,3
Trival Valderas,0,0,0,0,0,0,0,0,1,1,0,3
FC Lahti,44,43,25,112,147,115,32,40,36,108,122,135
Meyrin,0,0,1,1,0,3,0,0,0,0,0,0
CD Boiro,0,0,1,1,1,5,0,0,0,0,0,0
Stocksbridge,2,3,12,17,17,45,6,3,12,21,33,53
Radstock Town,0,0,0,0,0,0,0,0,2,2,0,4
Cove Rangers,65,10,12,87,236,61,56,14,24,94,219,114
Volvic C.S,0,0,1,1,0,1,0,0,0,0,0,0
Fjolnir Reykjavik,1,1,4,6,7,13,1,0,3,4,6,8
Aus. Vienna,57,33,51,141,223,195,52,36,55,143,214,208
Crewe,75,43,77,195,271,272,52,42,90,184,216,311
Barbados,2,1,7,10,5,17,3,2,5,10,15,16
Voluntari,35,35,50,120,136,148,30,31,59,120,118,191
Szombathelyi H,36,23,29,88,106,104,20,14,53,87,71,143
Varese,2,0,0,2,4,2,0,0,2,2,1,6
VSG Altglienicke,0,0,1,1,0,6,0,0,0,0,0,0
FC Minsk,43,32,33,108,150,134,32,24,52,108,119,149
Burkina Faso,9,12,2,23,39,23,9,7,13,29,25,33
Zlatibor Cajetina,3,3,12,18,10,27,4,4,10,18,18,36
Sporting,117,29,20,166,313,119,90,36,46,172,299,198
El Palmar,0,0,1,1,1,2,1,0,0,1,2,1
Glasgow Univ,0,0,1,1,2,8,0,0,1,1,0,3
Slavoj Vysehrad,0,0,0,0,0,0,0,0,1,1,0,8
Partick,59,34,62,155,215,208,48,42,67,157,178,215
Heanor Town,3,0,5,8,13,18,2,1,1,4,6,7
Legia Warsaw,102,38,33,173,313,154,88,31,46,165,246,164
Cerro Reyes At,0,0,0,0,0,0,0,0,1,1,1,2
Khazar,1,1,1,3,3,3,0,0,3,3,2,7
FC Naftan,16,17,26,59,58,85,15,13,32,60,62,97
Laverstock & Ford,0,0,0,0,0,0,0,0,1,1,1,3
Runcorn,3,1,3,7,12,13,3,1,4,8,20,20
SO Cholet,0,2,1,3,3,5,1,1,1,3,5,8
Frickley,32,15,33,80,110,110,20,18,49,87,100,165
Cosenza,3,3,2,8,10,9,4,3,7,14,16,22
Krumkachy,10,7,15,32,29,44,4,9,17,30,22,49
Floriana FC,2,4,5,11,13,16,3,0,3,6,6,8
Chasselay MDA,0,0,0,0,0,0,0,1,0,1,1,1
Austria Women,0,0,1,1,0,2,0,0,0,0,0,0
Glacis United,0,0,5,5,1,14,1,1,0,2,2,1
Heracles,61,24,41,126,230,179,29,27,69,125,136,238
Hawick Royal A,3,2,15,20,28,68,3,2,17,22,15,84
Saxan,0,2,3,5,4,8,1,1,7,9,8,25
Cesena,16,9,11,36,50,45,7,8,18,33,38,64
Rigas Futbola Skola,0,0,1,1,0,2,1,0,1,2,3,3
Southend M,0,0,1,1,1,4,0,0,0,0,0,0
Lyon-la-Duch.,1,1,0,2,3,1,1,1,1,3,2,3
U S Portsmouth,4,2,1,7,13,9,2,0,1,3,6,5
Raith,86,31,40,157,280,200,55,42,70,167,212,253
France,44,9,6,59,141,53,21,7,6,34,51,23
Slavia Karlovy Vary,0,0,0,0,0,0,0,0,1,1,3,10
TSV St. Johann,0,0,0,0,0,0,0,0,1,1,0,5
Redbridge,2,0,3,5,4,12,1,1,1,3,6,6
Ayia Napa,0,0,2,2,1,4,0,0,1,1,0,1
Heidenheim,55,25,28,108,182,130,34,35,45,114,142,158
Atl Madrid B,1,0,1,2,2,3,0,0,0,0,0,0
Rushall Oly.,49,25,36,110,172,130,43,24,44,111,175,185
Djibouti,2,0,3,5,4,11,0,1,7,8,2,34
Algeria Olympic,0,1,0,1,1,1,0,0,2,2,3,5
PSV Eindhoven,112,23,16,151,349,113,87,32,37,156,322,205
SV Todesfelde,0,0,1,1,0,1,0,0,0,0,0,0
Waterhouse FC,1,0,1,2,5,3,0,0,1,1,0,1
Edinburgh C,48,26,39,113,168,135,50,21,45,116,152,165
Glossop,5,4,3,12,21,13,6,1,4,11,19,16
St Mirren U20,3,0,1,4,7,6,2,1,3,6,7,13
Shamrock R B,6,4,13,23,27,37,5,4,14,23,19,41
Mouscron-P,42,31,55,128,165,182,26,27,74,127,140,235
Jordan,16,9,8,33,54,23,9,7,17,33,33,45
Limoges,0,0,3,3,3,15,0,0,0,0,0,0
MOL Vidi,88,31,27,146,271,125,62,39,42,143,209,147
Slough,74,34,43,151,253,191,57,37,56,150,253,240
FF Jaro,10,12,11,33,34,39,8,7,18,33,40,51
Algeciras,0,1,0,1,0,0,0,0,0,0,0,0
Wurzburger FV,0,0,1,1,0,2,0,0,0,0,0,0
FC Haka,1,2,8,11,9,25,4,5,4,13,17,20
Enfield,1,0,3,4,4,11,1,1,2,4,7,10
Valletta,14,8,9,31,36,35,12,7,12,31,45,49
Debenham LC,0,0,1,1,0,2,0,1,0,1,1,1
Longford T,46,22,39,107,166,144,41,27,45,113,144,153
Lincoln Utd,2,2,2,6,10,11,2,2,6,10,19,23
Siracusa,0,0,0,0,0,0,0,0,1,1,1,3
Solihull M,80,36,61,177,275,214,65,46,68,179,250,246
Dornbirn,0,0,1,1,1,5,0,0,0,0,0,0
Gorleston,5,1,3,9,24,19,0,0,2,2,2,6
Largs Athletic,0,0,1,1,0,1,0,0,1,1,0,3
Vasco,0,0,1,1,1,6,0,0,0,0,0,0
Platanias,27,18,26,71,83,81,14,15,43,72,54,111
Eastbourne,61,44,53,158,271,239,37,42,71,150,177,260
DAC,1,1,0,2,2,1,0,1,2,3,2,5
Simurg,1,1,1,3,3,3,0,0,2,2,0,2
Welling,62,30,63,155,235,207,38,38,81,157,175,259
Lucon,0,0,1,1,0,1,0,0,0,0,0,0
1860 Munich II,0,0,0,0,0,0,0,1,0,1,1,1
Padova,4,2,1,7,8,3,2,1,5,8,7,13
Frome,54,29,45,128,181,174,38,30,67,135,182,271
Atzeneta,0,0,0,0,0,0,0,0,1,1,0,1
Tranmere,96,45,67,208,316,256,69,53,66,188,228,244
Shakhtar,106,26,22,154,354,126,99,26,29,154,315,169
Mjondalen,15,9,21,45,61,77,3,16,27,46,42,91
Al-Nassr,0,0,0,0,0,0,0,0,1,1,1,5
Fleetwood,83,70,50,203,281,219,70,41,88,199,226,249
Stansted,2,0,0,2,6,1,0,0,2,2,0,6
Panionios,49,32,29,110,133,94,26,23,62,111,85,163
Team Northumbria,1,1,0,2,5,1,1,0,2,3,6,6
Walton Casuals,18,9,21,48,80,88,11,9,27,47,60,94
K Sports,0,0,0,0,0,0,0,0,1,1,3,4
Curzon A,58,32,51,141,204,194,37,48,57,142,167,209
Lund,0,0,1,1,0,2,0,0,0,0,0,0
Sociedad,78,45,46,169,274,194,56,43,69,168,211,232
Dumbarton,57,31,65,153,187,225,36,35,82,153,168,294
Panevezys,0,0,0,0,0,0,0,0,2,2,1,3
RKC Waalwijk,9,9,19,37,43,57,5,8,25,38,37,86
Racing (Lux),1,2,3,6,12,12,0,1,4,5,2,16
Jammerbugt,0,0,1,1,1,6,0,0,0,0,0,0
East Cowes Victoria Athletic,0,0,0,0,0,0,0,0,1,1,2,3
Ponferradina,51,30,23,104,145,94,19,29,60,108,79,157
Radnicki Nis,74,35,25,134,212,115,43,35,55,133,140,175
Samoa,1,0,0,1,3,2,1,0,4,5,3,20
Hashtag United,0,0,0,0,0,0,1,1,0,2,2,0
Lopes Tavares London,0,0,1,1,2,3,0,0,0,0,0,0
Sp C Thamesmead,0,0,1,1,1,5,1,0,1,2,3,2
Liechtenstein,2,5,19,26,11,65,4,4,24,32,14,90
Newton Abbot Spurs,1,0,1,2,3,9,0,0,1,1,1,3
Eastwood Com,2,0,0,2,6,2,3,0,3,6,9,19
Reading U23,3,1,3,7,9,13,3,3,5,11,20,22
London Bari,0,0,0,0,0,0,0,0,1,1,1,2
Al Duhail,0,0,1,1,0,1,1,0,0,1,3,1
Tabor,0,0,1,1,0,3,0,0,0,0,0,0
Holmer Green,0,1,0,1,2,2,1,0,2,3,1,10
Hassocks,1,0,1,2,3,8,0,0,0,0,0,0
Colne,2,0,4,6,13,17,5,0,3,8,15,15
Veres Rivne,3,8,5,16,15,18,4,6,7,17,13,16
Rainworth M,1,0,1,2,3,5,0,1,1,2,2,3
Plymouth P,8,0,3,11,36,19,4,1,4,9,18,18
1. FC Duren,0,0,1,1,0,3,0,0,0,0,0,0
PFC Montana,12,7,28,47,54,85,1,14,33,48,17,77
Celtic U20,1,0,1,2,6,3,1,3,3,7,7,16
Pachuca,2,0,0,2,5,1,2,0,2,4,13,8
Volna,0,0,2,2,4,7,0,0,0,0,0,0
Colliers Wood U,3,0,1,4,16,8,1,0,2,3,5,10
Aberdeen,96,41,37,174,286,167,90,32,60,182,248,204
Leicester,92,36,48,176,282,185,66,45,62,173,262,239
Slask Wroclaw,64,45,27,136,197,136,34,36,65,135,156,199
Chipstead,4,4,2,10,19,17,0,1,5,6,4,13
Banbury,36,19,37,92,148,147,27,24,40,91,122,161
Varzim,0,0,0,0,0,0,0,0,1,1,2,4
Ried,32,15,29,76,104,112,11,21,45,77,68,131
Tromsdalen,1,0,0,1,4,2,0,0,0,0,0,0
Concordia Basle,0,0,2,2,0,11,0,0,0,0,0,0
Beith,0,0,0,0,0,0,0,0,1,1,0,1
Bodo Glimt,51,19,23,93,210,120,29,22,40,91,137,157
Hamble Club,2,1,0,3,10,7,3,0,2,5,10,10
Wehen-Wiesb.,11,7,14,32,43,57,9,4,9,22,38,31
NKF Burbage,0,0,0,0,0,0,2,0,1,3,6,4
Dungannon Sw,47,23,66,136,179,230,27,36,74,137,140,265
SV Sandhausen,37,35,32,104,129,118,27,25,59,111,129,180
Swaffham Town,0,1,1,2,1,2,2,0,2,4,6,11
Horndean,1,0,3,4,5,8,3,1,3,7,10,9
Redhill,0,0,2,2,3,5,1,1,1,3,4,5
Dundee U U20,0,0,1,1,2,4,1,0,0,1,2,1
Haddington Athletic,0,0,1,1,1,2,0,0,0,0,0,0
Sioni,2,0,5,7,12,16,1,1,3,5,3,9
Travnik,0,0,1,1,2,3,0,0,1,1,0,1
Gzira United,0,1,4,5,2,8,1,1,5,7,6,17
Olginatese,0,0,0,0,0,0,0,0,1,1,1,2
Stotfold,1,0,1,2,6,3,0,0,1,1,0,1
Dalkurd FF,4,3,9,16,21,32,3,3,11,17,14,34
Fortuna Singelik,0,0,1,1,0,11,0,0,0,0,0,0
Grande Synthe,0,0,1,1,0,1,0,0,0,0,0,0
Myanmar,6,0,8,14,19,25,2,2,9,13,10,41
Ankaragucu,18,12,23,53,61,76,10,14,29,53,53,94
Oldham,69,51,75,195,266,274,52,66,77,195,213,281
Irvine,0,0,1,1,1,2,0,0,0,0,0,0
Portimonense,27,17,23,67,98,87,10,16,43,69,64,122
Be. Perigord,7,3,2,12,18,11,2,1,4,7,8,10
Montrose,66,28,55,149,219,235,52,34,70,156,193,261
Rakvere Tarvas,0,0,3,3,1,12,0,0,0,0,0,0
Munsingen,0,0,1,1,0,3,0,0,0,0,0,0
Cigand SE,0,0,1,1,0,2,0,0,0,0,0,0
Brimsdown,0,0,0,0,0,0,0,0,1,1,0,3
Fleury 91,3,1,3,7,11,8,1,1,3,5,5,7
Thornaby,1,1,0,2,10,6,1,0,1,2,10,8
L'Hospitalet,1,0,3,4,6,12,1,1,0,2,3,2
Ingolstadt,23,21,33,77,99,108,22,21,38,81,85,119
Slavia Sofia,54,27,44,125,169,148,43,27,57,127,134,171
Chippenham,72,40,41,153,247,182,54,35,66,155,206,234
Piacenza,1,1,1,3,3,3,1,1,2,4,5,7
Black Country Rangers,0,0,1,1,5,9,0,1,1,2,4,5
A Villa U23,0,0,2,2,2,6,2,1,0,3,5,2
Vikingur Gota,8,3,8,19,28,25,13,5,4,22,44,32
Meridian VP,1,0,2,3,3,7,0,0,0,0,0,0
Fakenham Town,1,3,0,4,6,5,1,0,1,2,4,3
Kilmarnock,65,34,66,165,228,209,45,41,70,156,155,228
Aalesund,26,21,29,76,117,118,18,13,46,77,81,167
Cardiff,79,44,59,182,254,226,58,48,74,180,209,253
Sepsi Sfantu G,27,22,26,75,88,80,19,29,29,77,84,101
New Zealand,6,2,2,10,17,8,6,4,14,24,27,32
Marseille,90,39,36,165,289,179,65,52,62,179,255,238
Central Coast M,29,18,51,98,124,189,14,21,65,100,103,208
Haverfordwest,7,10,14,31,26,45,7,3,22,32,37,68
Tamaraceite,1,0,1,2,3,3,0,0,0,0,0,0
Leonzio,0,0,0,0,0,0,0,0,1,1,0,2
Greenwich B,3,0,3,6,15,8,3,1,4,8,18,18
Leicester U23,2,1,5,8,12,14,1,3,5,9,6,21
Martigues,0,0,1,1,1,3,0,0,0,0,0,0
Strommen,0,0,0,0,0,0,0,0,1,1,0,2
Lions Gibraltar,0,1,2,3,1,11,0,0,3,3,2,15
Man Utd U21,3,3,1,7,7,8,8,4,5,17,28,25
Treaty United,2,1,0,3,4,2,0,3,1,4,5,6
Teplice,45,36,34,115,151,132,22,32,61,115,113,202
Norway Women,2,1,2,5,11,7,3,0,1,4,9,4
NK Ivan. Gorica,0,0,1,1,0,3,0,0,0,0,0,0
FAS,0,1,1,2,2,3,0,0,1,1,0,2
Barcelona B,19,11,24,54,80,73,14,16,25,55,64,85
Strathspey T,13,4,34,51,57,149,9,2,39,50,57,160
Rayners Lane,1,0,0,1,3,2,0,0,0,0,0,0
Cullompton R,1,1,1,3,2,2,1,0,2,3,6,8
Vestsjaelland,8,7,8,23,23,25,4,7,13,24,19,42
Nth Ferriby,43,29,42,114,160,166,33,24,53,110,132,196
Zadar,10,4,12,26,35,39,4,4,18,26,22,70
Ipswich,73,59,52,184,237,193,52,46,89,187,188,266
Heston R,0,0,1,1,0,6,0,0,0,0,0,0
Bayamon,0,0,2,2,1,12,0,0,0,0,0,0
Cape Verde Is.,7,3,5,15,17,13,5,3,8,16,12,19
BetLanes,0,0,1,1,1,2,0,0,0,0,0,0
Pescara,11,13,15,39,57,62,5,6,27,38,37,80
Lok Stendal,0,0,1,1,0,5,0,0,0,0,0,0
KFCO Beerschot-W,10,6,11,27,45,46,7,5,15,27,38,58
Roma,119,39,31,189,390,199,83,44,57,184,292,250
Bassecourt,0,0,1,1,0,6,0,0,0,0,0,0
San Sebastian,1,0,1,2,2,2,0,0,1,1,1,3
Wantage Town,1,0,3,4,7,13,3,0,4,7,14,16
Guingamp II,0,0,0,0,0,0,0,1,0,1,1,1
Rapid Ghidighici,0,0,1,1,0,3,0,0,0,0,0,0
Crusaders,96,23,26,145,328,149,82,30,43,155,296,215
Go A Eagles,11,6,27,44,45,78,6,9,29,44,35,92
Holland U21,1,1,0,2,7,2,0,2,1,3,2,5
St Kitts and Nev,4,3,1,8,16,8,4,0,5,9,15,19
Blue Boys Mulenbach,0,0,0,0,0,0,0,0,1,1,1,3
Skalica,0,0,1,1,0,3,0,0,1,1,1,2
Skenderbeu,26,9,6,41,84,39,16,7,14,37,56,43
Wisla Plock,34,21,34,89,116,112,26,25,37,88,114,146
Rhyl,17,17,22,56,74,82,12,11,31,54,67,119
Chelsea U21,5,5,6,16,21,24,17,5,11,33,62,45
Orgryte,0,0,1,1,0,1,0,0,2,2,0,5
San Fernando,1,0,2,3,4,7,1,0,1,2,4,4
Ravenna,1,0,0,1,1,0,0,1,1,2,2,3
St Liege,93,43,30,166,293,173,46,39,75,160,196,251
Zhetysu,1,1,0,2,2,1,0,0,6,6,2,12
Lyon II,2,0,0,2,5,2,0,0,0,0,0,0
Chelsea,136,46,30,212,439,177,106,42,53,201,328,230
Fougeres AGL,1,0,0,1,3,2,0,0,0,0,0,0
TB/FCS/ROYN,0,0,0,0,0,0,0,0,1,1,0,3
Qaradag Lok,0,0,0,0,0,0,0,0,1,1,0,2
Chrudim,0,0,0,0,0,0,0,0,1,1,1,3
Sunderland U21,2,0,6,8,6,19,1,5,7,13,9,25
Peru,19,6,12,37,52,43,14,11,18,43,49,49
Hereford Lads Club,1,0,0,1,2,0,0,0,1,1,1,3
Ourense,0,0,1,1,0,1,0,0,0,0,0,0
Reading,79,50,66,195,264,226,58,54,84,196,230,295
Broxburn,0,0,1,1,1,2,0,0,0,0,0,0
Hurlford,0,1,1,2,1,6,2,1,0,3,12,3
Wadham Lodge,1,0,1,2,2,4,0,0,0,0,0,0
FC Still 1930,0,0,1,1,0,1,0,0,0,0,0,0
Hull U21,1,0,0,1,1,0,1,0,1,2,3,3
Slovan Liberec,70,40,25,135,225,125,46,26,68,140,140,204
Stockton T,7,0,4,11,23,13,8,0,2,10,25,9
Partizan Tirana,5,10,8,23,21,20,4,6,9,19,16,29
Cologne II,0,0,0,0,0,0,0,0,1,1,1,2
FC Brno,31,25,27,83,90,91,14,20,48,82,73,145
Rochester United,0,0,0,0,0,0,0,0,1,1,1,3
Saint-Meziery,0,0,0,0,0,0,0,0,1,1,0,5
Ramon y Cajal,0,0,1,1,1,2,0,0,0,0,0,0
Columbus Crew,59,26,17,102,186,115,17,27,54,98,96,164
England Women,6,0,5,11,14,11,3,1,0,4,10,2
Stabaek,43,28,36,107,151,137,29,34,44,107,146,183
Team Solent,3,0,2,5,10,8,2,0,1,3,5,6
Deportivo,46,49,44,139,183,189,29,52,60,141,125,214
Carpi,12,12,11,35,50,46,7,9,18,34,29,58
Romsey Town,0,0,3,3,5,9,0,0,0,0,0,0
Shukura,0,1,1,2,2,4,0,0,2,2,2,6
Germany Olympic,1,1,0,2,13,3,2,2,0,4,9,3
Stjarnan,11,6,9,26,39,40,10,5,10,25,35,40
Orlando City,39,29,31,99,161,140,18,27,48,93,105,176
Lebanon,3,5,4,12,17,13,6,2,5,13,11,9
Tauro,1,0,2,3,2,4,0,0,4,4,3,13
Guangzhou Ev,1,0,0,1,3,0,1,0,2,3,3,6
Romania,18,14,8,40,56,36,11,8,10,29,42,37
Brondby,77,36,32,145,272,154,65,25,53,143,209,187
Kashima Antlers,1,1,2,4,6,11,2,0,1,3,7,4
Tskhinvali,2,0,1,3,11,5,1,3,0,4,6,5
Croatia,29,6,4,39,86,28,15,13,16,44,62,61
SV Sandhausen II,0,1,0,1,1,1,0,0,0,0,0,0
Cadiz II,0,0,0,0,0,0,0,1,0,1,0,0
Sint Maarten,0,0,0,0,0,0,0,0,1,1,0,12
Lillestrom,42,24,26,92,139,104,16,29,47,92,112,169
Bamber Br.,21,8,17,46,92,76,8,11,33,52,52,100
Vardar Skopje,18,5,4,27,52,28,8,7,13,28,38,47
Chindia Targoviste,13,11,14,38,42,46,10,9,18,37,27,45
Soloman Islands,3,2,3,8,10,9,2,1,6,9,5,16
Waltham Forest,0,0,3,3,4,7,1,1,0,2,4,2
Andorra,2,7,22,31,11,54,2,4,21,27,6,71
Turriff U,14,9,35,58,97,139,19,6,37,62,100,162
Kolos Kovalivka,14,7,11,32,44,38,10,8,15,33,34,51
Arsenal,141,40,37,218,444,202,90,45,66,201,331,272
Bedfont & Feltham,1,0,1,2,4,3,0,0,1,1,1,5
Swarovski Wattens,7,8,15,30,36,55,9,7,15,31,47,62
Walton & H,3,1,1,5,11,5,3,1,4,8,18,13
Backa Topola,19,9,6,34,80,41,14,7,14,35,51,52
Cambridge C,33,18,34,85,127,126,21,17,44,82,111,140
Guisborough T,3,0,4,7,17,17,1,1,2,4,7,10
Illueca,0,0,1,1,0,2,0,0,0,0,0,0
Gornik Leczna,20,12,22,54,73,72,10,18,29,57,53,90
Malmo,94,32,17,143,311,121,68,34,40,142,223,169
Hereford.,4,2,6,12,13,14,4,3,6,13,10,23
IF BP,8,5,22,35,34,63,5,6,25,36,32,87
Stromsgodset,54,28,28,110,201,149,29,28,55,112,143,195
Djurgaardens,55,29,28,112,191,120,52,22,37,111,170,127
Gemenos,0,1,0,1,1,1,0,0,0,0,0,0
Galway FC,43,25,44,112,166,149,29,34,42,105,140,153
Billingham S,0,0,0,0,0,0,0,0,2,2,1,4
Lambresienne,0,0,0,0,0,0,0,0,1,1,0,5
Wuppertaler,0,0,1,1,2,5,0,0,0,0,0,0
Wolfsberg (Aus),0,0,1,1,0,6,0,0,0,0,0,0
Macau,2,1,1,4,7,6,0,0,3,3,0,10
Cracovia,65,37,35,137,209,155,32,39,65,136,145,190
Boavista,47,24,48,119,124,123,22,37,58,117,94,176
Ronse,0,0,1,1,0,3,0,0,0,0,0,0
Andover Town,0,0,2,2,2,6,1,0,1,2,3,3
Breitenrain,0,0,2,2,2,7,0,0,0,0,0,0
Llandudno,19,17,29,65,76,102,17,20,28,65,82,105
Hebburn Town,7,1,1,9,19,8,6,1,2,9,21,12
Wisla Krakow,54,34,43,131,204,155,37,36,62,135,185,221
Yzeure,2,0,3,5,7,11,1,0,0,1,3,1
SV Eichede,0,0,1,1,0,4,0,0,0,0,0,0
Lincoln,101,53,43,197,333,218,78,50,72,200,280,266
Club Brugge,122,33,23,178,390,156,79,43,59,181,286,222
QPR,81,41,67,189,288,258,41,40,96,177,167,281
Easington C.W.,0,0,0,0,0,0,0,0,1,1,1,3
Akzhayik,0,0,2,2,2,7,0,0,1,1,0,2
Desna,21,7,18,46,63,51,18,11,17,46,69,59
New Mills,2,1,1,4,8,10,1,0,2,3,3,6
Terracina,0,0,0,0,0,0,0,0,1,1,0,6
Stutt. Kickers,0,0,2,2,2,8,0,1,0,1,3,3
Hollenbach,1,0,0,1,1,0,0,0,0,0,0,0
Cadiz,55,42,25,122,153,105,44,35,43,122,128,129
Hearts U20,3,1,2,6,13,9,4,0,4,8,16,16
FC Utrecht,69,34,30,133,241,163,44,39,51,134,207,219
Espanyol B,0,1,0,1,2,2,0,0,0,0,0,0
Hoffenheim,69,32,39,140,265,193,41,53,58,152,249,253
Bryne,0,0,1,1,2,6,1,0,0,1,3,2
Skonto Riga,9,2,1,12,27,10,1,0,2,3,4,10
Valenciennes,11,4,13,28,36,43,3,7,20,30,25,60
Kuban K,13,12,13,38,53,48,5,13,18,36,29,52
Ararat,0,2,5,7,8,17,2,0,5,7,7,15
Olympiakos,133,21,19,173,397,111,93,35,45,173,289,168
Entente SSG,2,3,4,9,5,11,0,1,2,3,1,3
Europa,6,1,7,14,26,22,5,1,10,16,17,30
Iceland U21,0,0,3,3,2,11,0,0,1,1,1,4
Cincinnati,5,7,16,28,20,46,5,5,23,33,26,76
Casa Pia,0,0,1,1,0,3,0,0,0,0,0,0
Malaga,62,41,55,158,193,162,37,43,76,156,124,198
CSKA Sofia,80,32,11,123,228,63,54,33,32,119,151,98
Ross County U20,1,0,2,3,5,6,0,0,1,1,0,4
Dukla Prague,33,18,33,84,118,109,14,22,49,85,77,159
Young Boys,123,23,25,171,415,186,78,47,48,173,273,234
Extremadura,14,9,23,46,48,55,11,16,18,45,46,62
Leicester Road,0,0,1,1,2,4,0,0,1,1,4,5
Angouleme,1,1,2,4,5,8,0,0,1,1,2,4
Hayes & Y,35,29,47,111,148,159,32,25,47,104,129,173
Napredak,51,30,30,111,156,115,27,21,62,110,111,176
Mlada Boleslav,62,30,33,125,224,145,40,34,54,128,167,201
Speranta Nisporeni,0,0,5,5,3,12,1,0,5,6,1,17
Ballymena,65,23,57,145,256,248,45,26,66,137,188,237
Haverhill Rov,0,0,0,0,0,0,0,0,1,1,0,2
Cambuur,17,8,19,44,57,66,4,15,24,43,48,95
Needham M,30,19,31,80,118,128,24,18,34,76,105,142
Eskisehirspor,14,10,18,42,57,67,5,17,20,42,38,68
Westerlo,15,15,24,54,67,86,9,16,28,53,63,126
Honved,56,33,42,131,191,166,38,29,56,123,139,156
Swansea U21,2,2,8,12,13,21,9,3,7,19,25,27
Logrones,11,11,13,35,31,40,10,10,13,33,27,39
Mladost Pod.,7,1,10,18,30,32,6,3,3,12,16,11
Portmore United,0,0,1,1,1,2,0,0,1,1,0,4
LKS Lodz,5,3,10,18,21,29,1,3,15,19,12,39
Formartine Utd,47,9,15,71,220,84,43,8,17,68,183,83
Herne Bay,1,3,1,5,6,6,5,1,5,11,17,27
Newport Co,85,62,63,210,265,237,52,49,91,192,205,280
Dorking W,48,14,21,83,191,109,33,18,28,79,117,108
West Brom,60,54,56,170,251,239,48,46,71,165,169,224
Houston,41,24,20,85,153,100,10,24,52,86,91,159
St Mirren,64,38,64,166,223,202,48,34,83,165,194,280
Studley,0,0,1,1,1,4,0,0,1,1,2,3
Farsley,0,0,0,0,0,0,0,0,1,1,0,4
Trelissac,1,3,1,5,6,6,2,1,3,6,7,8
Burundi,4,3,4,11,19,12,4,7,6,17,22,23
Spennymoor,62,28,21,111,238,133,41,28,36,105,173,147
Azerbaijan,7,11,13,31,27,34,6,7,19,32,24,61
Trinidad,8,8,11,27,32,28,4,8,21,33,27,80
Sholing,11,4,4,19,32,20,7,1,3,11,18,15
FC Eintracht Norderstedt,0,0,3,3,1,12,0,0,0,0,0,0
Preussen Mun,1,0,3,4,5,7,0,1,2,3,2,4
Golspie,0,0,1,1,1,4,0,0,0,0,0,0
FC Groningen,61,35,34,130,189,142,31,37,63,131,151,212
AEL Limassol,6,2,9,17,24,29,7,8,11,26,24,42
FK Atyrau,1,1,2,4,4,7,0,1,6,7,3,23
Everton U23,5,1,1,7,12,4,4,1,1,6,15,4
Monopoli,3,1,0,4,7,2,0,1,3,4,4,10
Zenit,107,24,19,150,359,122,69,37,44,150,207,153
Stade Bordelais,1,0,0,1,2,1,1,0,1,2,2,2
Basingstoke,61,28,42,131,225,178,39,25,68,132,196,226
Botosani,66,40,40,146,199,154,42,41,60,143,156,184
Belize,2,2,1,5,9,4,1,2,7,10,7,19
Zalgiris,1,1,0,2,3,1,0,0,2,2,2,6
UT Arad,3,5,11,19,11,24,9,5,4,18,21,21
RapalloBogliasco,0,0,0,0,0,0,0,0,1,1,0,4
Vancouver W,40,23,30,93,146,128,29,17,50,96,102,170
Turkmenistan,5,2,3,10,12,12,2,0,8,10,12,21
Carmarthen,36,19,48,103,147,173,31,19,49,99,125,181
Man City,154,25,29,208,547,173,138,37,46,221,447,208
Cabinteely,34,16,34,84,104,106,22,17,50,89,90,170
W Brom U23,3,0,1,4,5,4,1,0,4,5,6,10
Viby,0,0,1,1,0,3,0,0,0,0,0,0
Senegal,23,9,4,36,57,14,19,10,7,36,52,31
Winsford Utd,0,0,1,1,2,3,0,0,2,2,1,3
Northwich,9,5,2,16,39,13,8,4,4,16,31,19
Newquay,0,0,1,1,1,3,0,0,1,1,0,6
Petrolul Ploiesti,16,12,19,47,53,52,14,16,18,48,51,47
Guia,0,0,1,1,0,1,0,0,0,0,0,0
Salisbury FC,40,12,14,66,132,91,24,19,18,61,125,94
Nigeria Women,4,1,1,6,23,2,0,1,3,4,1,8
Blidworth Welfare,1,0,3,4,7,6,2,1,1,4,11,7
Southend,76,47,72,195,250,240,50,48,88,186,199,287
Winchester City,0,2,3,5,5,10,4,0,3,7,18,14
BSG Chemie Leipzig,1,0,1,2,2,4,0,0,0,0,0,0
Marchamalo,0,0,1,1,2,3,0,1,0,1,0,0
Woking,81,45,57,183,271,228,62,38,85,185,260,302
Nashville MLS,6,8,2,16,23,13,5,3,6,14,11,15
Chippenham Park,0,0,1,1,1,2,1,0,0,1,2,1
Austria U21,3,2,1,6,10,9,2,3,2,7,4,6
Hansa Rostock,2,2,5,9,7,12,1,0,2,3,3,4
Montceau,0,0,0,0,0,0,0,0,1,1,0,3
ESA Linas Montlhery,0,0,1,1,0,6,0,0,0,0,0,0
Zira,2,4,8,14,9,28,2,4,4,10,12,16
S'ampton U23,5,3,2,10,18,9,3,1,2,6,9,8
Oxford,96,50,63,209,328,236,77,61,72,210,297,265
Stafford,34,33,36,103,142,146,26,28,54,108,125,176
Peterboro' NS,3,0,2,5,7,6,1,1,3,5,7,16
Tavriya Simf.,0,0,6,6,1,11,0,2,3,5,2,5
Olympic,0,0,1,1,0,16,0,0,0,0,0,0
Drogheda,48,25,42,115,170,151,42,22,52,116,166,192
Cray Valley PM,5,0,2,7,13,7,5,4,4,13,31,23
Steaua,95,45,28,168,299,142,84,36,43,163,247,163
Zeljeznicar,12,5,4,21,28,16,6,7,8,21,23,25
Newton Aycliffe,3,0,1,4,9,3,2,0,2,4,13,11
Caronnese,0,0,0,0,0,0,0,0,1,1,1,2
Pro Patria,1,0,0,1,1,0,2,0,3,5,5,10
Al Sadd (Qatar),1,0,1,2,5,7,0,0,1,1,2,3
Leiston,57,26,31,114,217,133,43,32,42,117,188,180
Nigeria,21,9,10,40,60,34,12,12,11,35,41,38
Levadiakos,34,26,26,86,104,98,13,16,56,85,52,129
TuS Haltern,0,0,0,0,0,0,0,0,1,1,0,2
Austria Lustenau,0,0,1,1,0,1,0,0,1,1,0,5
A Mancha R,0,0,0,0,0,0,0,0,1,1,0,5
Coalville,17,9,25,51,88,101,19,10,26,55,82,96
Shortwood Utd,1,1,1,3,3,2,2,0,3,5,10,11
Viktoria Plzen,109,24,18,151,320,127,68,35,42,145,199,170
FK Belasica,0,0,1,1,0,3,0,0,1,1,1,4
M. Tel Aviv,120,36,23,179,346,127,95,43,38,176,268,161
Lusitano FCV,0,0,1,1,1,4,0,0,0,0,0,0
Vaduz,23,31,36,90,107,129,24,20,49,93,113,173
Montlucon,0,1,1,2,1,2,0,0,0,0,0,0
Beziers,4,0,3,7,5,4,1,4,1,6,8,5
KA Akureyri,0,1,1,2,2,3,0,0,2,2,1,4
Ch'morets B,4,0,4,8,18,13,3,2,2,7,11,9
Yen. Krasnoyarsk,5,7,5,17,20,23,1,1,15,17,12,38
Stafford Town,0,0,1,1,0,1,0,0,0,0,0,0
Vale of Leith,1,0,0,1,1,0,0,0,0,0,0,0
Izarra,2,0,1,3,9,7,0,0,1,1,2,3
Gil Vicente,15,21,24,60,55,80,13,10,36,59,50,88
Hesperange,0,0,1,1,0,7,0,0,0,0,0,0
Sloga Mravince,0,0,1,1,0,1,0,0,0,0,0,0
Saint-Malo,6,0,2,8,17,7,1,1,0,2,3,1
Ex Maassluis,0,0,1,1,0,4,0,0,0,0,0,0
Fram Reykjavik,0,1,3,4,2,8,1,1,1,3,8,6
Club Atletico Antoniano,1,0,1,2,2,4,0,0,0,0,0,0
Chicago,43,27,25,95,173,116,9,23,57,89,92,176
R-W Erfurt,0,1,1,2,1,4,0,0,1,1,0,3
Hullbridge S,6,1,4,11,16,15,2,0,4,6,8,17
Fortuna Cologne,1,1,0,2,2,1,0,0,2,2,1,5
Levadia Tallinn,10,3,2,15,42,8,12,3,6,21,51,28
E Thurrock,68,44,49,161,288,219,48,32,70,150,225,282
SV Meppen,2,1,2,5,10,9,2,0,0,2,4,1
Stoke,71,39,61,171,230,210,42,58,74,174,169,252
AFC Darwen,1,0,2,3,7,8,0,0,0,0,0,0
East Grinstead Town,1,0,5,6,9,21,3,1,2,6,9,5
Olhanense,3,3,3,9,8,9,1,0,7,8,5,18
Cobham,1,0,2,3,1,5,1,0,1,2,6,2
Rapid Buch.,3,6,8,17,13,23,5,3,9,17,8,19
Llanelli,2,3,11,16,14,49,2,1,13,16,17,55
Spal,20,20,28,68,78,102,16,11,43,70,63,120
Cardassar,0,1,1,2,0,3,0,0,0,0,0,0
Gornal Athletic,1,0,0,1,3,2,0,0,1,1,1,4
Moldova,2,8,16,26,16,49,6,10,31,47,24,77
Haiti,9,1,6,16,33,16,10,5,15,30,35,51
Deinze,1,0,0,1,2,0,0,0,0,0,0,0
Uganda,12,7,4,23,29,9,9,10,17,36,22,36
RC Lorrain,0,0,1,1,1,3,0,0,0,0,0,0
Wisbech Town,2,1,5,8,12,16,5,0,3,8,11,7
Croydon,3,0,0,3,9,4,0,0,4,4,3,16
Germania,0,0,0,0,0,0,0,0,1,1,0,3
San Marino,0,2,24,26,1,81,0,1,24,25,3,119
Getafe,71,42,46,159,198,133,39,44,82,165,145,255
Auchinleck,14,2,2,18,56,15,11,5,4,20,40,22
Bourg-Peronnas,5,4,10,19,20,41,6,3,7,16,21,28
Workington,70,23,43,136,219,155,53,27,63,143,187,227
Ards,19,12,36,67,82,120,13,14,38,65,69,122
Riteriai,1,1,2,4,6,10,1,1,0,2,2,1
Dunstable,31,11,53,95,120,186,24,20,51,95,102,181
Penrith,1,0,2,3,3,6,1,0,1,2,1,3
Rain-Lech,0,0,0,0,0,0,0,1,0,1,1,1
Trencin,18,3,10,31,67,43,16,3,4,23,45,26
Kennington,1,2,1,4,7,10,1,0,0,1,2,0
Bristol R,96,41,66,203,310,226,56,54,81,191,208,268
Montlingen,0,0,1,1,0,3,0,0,0,0,0,0
Pully Football,0,0,1,1,1,4,0,0,0,0,0,0
Tabor Sezana,17,9,9,35,48,40,7,5,22,34,34,52
Lucchese,0,0,0,0,0,0,0,1,2,3,3,7
N'thampton On C,0,0,2,2,4,8,0,0,1,1,1,3
SV Grodig,14,11,20,45,63,69,12,8,26,46,54,89
Hitchin,62,24,29,115,211,127,40,34,41,115,156,160
Loures,0,0,1,1,1,2,0,0,0,0,0,0
Gudja United,0,0,0,0,0,0,1,0,0,1,2,0
Beckenham T,2,1,2,5,18,14,1,2,2,5,9,12
Ullensaker / Kisa,0,0,2,2,2,5,0,0,0,0,0,0
Zalaegerszeg,11,11,11,33,57,47,10,6,17,33,52,55
Cantolagua,0,0,1,1,0,5,1,0,0,1,1,0
Bursaspor,41,27,26,94,136,106,23,20,52,95,104,162
Erciyesspor,8,6,12,26,36,43,4,10,11,25,29,41
Folkestone,59,15,24,98,205,111,31,24,41,96,157,175
Lok. Moscow,65,37,30,132,180,117,54,34,41,129,169,154
Sant Andreu,2,0,1,3,2,1,0,1,1,2,1,5
Cork Celtic,0,0,0,0,0,0,1,0,0,1,1,0
Omonia Nicosia,11,11,10,32,49,38,8,7,19,34,32,47
Kisvarda,17,15,16,48,56,53,17,9,25,51,52,74
Bearsted,3,0,2,5,9,6,0,0,0,0,0,0
Clevedon T,4,0,1,5,14,9,0,0,2,2,1,3
Coventry Sph,1,1,2,4,11,8,1,1,0,2,10,6
London Lions,1,0,0,1,3,2,0,0,1,1,0,1
Oissel,0,0,1,1,0,1,0,1,0,1,1,1
Mossley,3,0,2,5,8,7,2,1,4,7,12,20
Cacereno,1,1,1,3,2,2,0,0,1,1,1,3
Milton United,0,1,0,1,2,2,0,0,0,0,0,0
Ankaran Hrvatini,3,4,11,18,13,37,2,7,9,18,20,47
Blansko,0,0,0,0,0,0,0,0,1,1,0,2
Newcastle,67,36,57,160,230,200,46,35,84,165,170,260
Botev Plovdiv,64,29,38,131,198,133,29,36,67,132,128,205
Ibiza,5,2,2,9,16,10,3,2,0,5,5,0
KS Luftetari,1,2,0,3,5,4,0,1,3,4,2,11
Furiani-Agliani,0,0,0,0,0,0,0,1,1,2,2,3
West Bridgford,0,0,1,1,0,2,1,0,0,1,4,2
Dunbar U,0,0,2,2,1,5,0,0,0,0,0,0
Pagham,2,0,2,4,7,7,2,0,3,5,10,16
Zebbug Rangers,0,0,1,1,1,3,0,0,0,0,0,0
Creteil,4,3,2,9,17,11,4,4,4,12,15,14
Panaitolikos,0,0,0,0,0,0,0,0,1,1,0,3
Yeclano,1,0,3,4,6,8,1,0,0,1,2,1
Sevilla Atletico,14,16,12,42,56,49,6,9,27,42,28,67
Samaritaine,0,0,0,0,0,0,0,0,1,1,0,2
Rincon,0,0,1,1,0,2,1,0,0,1,2,1
Volgar Gaz. Ast,0,0,2,2,0,5,0,0,1,1,0,2
Jablonec,71,33,21,125,230,108,41,33,54,128,159,184
Yate,10,4,14,28,44,56,4,7,15,26,27,50
Cameroon Women,3,0,0,3,8,4,0,0,5,5,1,12
Flamurtari,3,3,4,10,13,14,3,1,7,11,11,19
S Roque de Lepe,0,0,1,1,0,3,0,0,0,0,0,0
Ballinamallard U,25,19,44,88,109,151,12,16,55,83,70,177
Vaprus,0,0,1,1,0,10,0,0,1,1,1,11
Tigres,10,0,1,11,30,9,3,2,5,10,11,12
Mensajero,1,0,3,4,2,8,0,0,0,0,0,0
Rapperswil-Jona,0,0,1,1,1,2,0,0,0,0,0,0
Scunthorpe,79,62,61,202,274,236,60,46,82,188,234,290
N Greenford U,1,0,1,2,2,2,1,1,2,4,12,13
Gremio,1,0,0,1,1,0,0,0,1,1,0,1
UCAM Murcia,12,7,12,31,40,37,7,10,11,28,26,38
Vauxhall M,6,0,8,14,21,26,3,4,6,13,14,25
AltoVicentino,0,0,0,0,0,0,0,0,3,3,2,7
Lovcen,1,2,4,7,6,11,0,2,3,5,3,10
Wick,0,0,2,2,0,4,0,0,0,0,0,0
Naxxar Lions,0,0,1,1,0,4,0,0,0,0,0,0
Herfolge,0,0,0,0,0,0,0,1,0,1,2,2
Portland Timb.,59,24,19,102,191,107,26,26,51,103,132,189
Mantes,1,0,1,2,2,1,0,0,2,2,0,4
Budafoki,4,2,11,17,20,40,3,4,9,16,14,34
Pegasus Jnrs,1,0,0,1,4,0,0,0,1,1,1,3
OB Odense,57,28,41,126,184,133,31,33,63,127,136,202
D'fermline U20,0,0,1,1,1,4,0,0,0,0,0,0
San Lorenzo,1,0,0,1,2,1,0,0,1,1,0,2
TPS Turku,15,12,19,46,53,62,5,10,33,48,41,94
Biesheim,1,1,0,2,5,3,1,0,0,1,1,0
Penistone Church,1,0,2,3,5,4,0,1,0,1,1,1
Nyonnais,0,0,1,1,0,1,0,0,0,0,0,0
NK Rudes,11,5,20,36,36,63,2,10,24,36,31,79
Croydon Ath,1,1,1,3,7,5,0,0,1,1,3,9
Unionistas,2,2,1,5,5,5,2,1,1,4,11,4
Lorca Dep.,1,0,3,4,4,8,0,0,2,2,2,6
Dieppe,0,0,1,1,1,3,0,0,0,0,0,0
Hendon,71,40,44,155,262,211,54,35,65,154,242,281
Paide Linnameeskond,0,0,0,0,0,0,0,0,1,1,0,2
Boulogne,6,7,4,17,28,22,4,4,4,12,15,14
Ascoli,6,2,4,12,24,23,1,4,8,13,13,28
Lleida,5,0,0,5,10,1,0,1,3,4,2,6
Reutlingen,2,1,1,4,8,7,1,1,2,4,8,6
Newcastle University,0,0,0,0,0,0,0,0,1,1,1,3
Daugava Riga,2,0,1,3,5,3,1,1,3,5,3,12
St Polten,19,23,46,88,92,163,20,20,47,87,92,157
Mulhouse,0,0,2,2,3,6,0,0,0,0,0,0
KPS Kuopio,56,31,25,112,163,105,40,32,42,114,151,147
FK Riga,2,2,1,5,3,3,0,1,1,2,0,1
Falkirk U20,0,0,0,0,0,0,0,0,1,1,2,3
SS Virtus,0,0,3,3,2,8,0,0,1,1,1,4
Pandurii,20,24,19,63,79,70,22,15,28,65,72,88
Trapani,9,4,3,16,35,14,1,0,7,8,3,22
Wellingboro T,5,0,1,6,10,11,1,0,2,3,6,8
Switz'land U21,1,0,1,2,4,4,1,0,1,2,3,3
Tours,8,6,13,27,32,40,8,9,12,29,39,37
Antigua & Barb,5,1,2,8,16,10,2,1,6,9,12,18
Islavale,0,0,0,0,0,0,0,0,1,1,1,2
Botswana,3,5,7,15,9,16,1,2,12,15,6,22
Montreal Imp,48,16,34,98,160,129,24,22,53,99,125,194
Top Oss,0,0,1,1,0,2,0,0,0,0,0,0
LKS Nieciecza,18,15,21,54,64,70,14,13,30,57,49,101
Wembley,3,0,2,5,15,14,1,0,2,3,8,9
Reggina,2,1,1,4,4,3,0,0,2,2,1,4
USM Senlis,0,0,1,1,0,4,0,0,0,0,0,0
Dunav Ruse,20,20,26,66,66,83,16,13,38,67,66,118
Sabadell,19,21,15,55,71,71,10,15,31,56,42,86
St Patrick's,62,24,44,130,198,151,41,35,48,124,139,155
Vanuatu,3,2,3,8,52,11,1,1,2,4,5,11
Grindavik,2,0,0,2,4,0,1,0,4,5,3,9
Radnik Surdulica,49,25,33,107,150,135,21,24,62,107,95,179
Apollon Smyrni,16,13,27,56,59,77,10,13,33,56,35,78
N Ireland U-21,0,0,0,0,0,0,0,0,1,1,0,2
Great Wakering,0,1,3,4,5,10,2,0,4,6,5,13
Union Titus Petange,0,0,0,0,0,0,0,0,1,1,0,2
Aston Villa,74,42,60,176,257,239,47,35,87,169,173,243
BSC Hastedt,0,0,1,1,1,11,0,0,0,0,0,0
Banants,3,0,8,11,11,23,3,0,9,12,8,22
Barnton,1,0,1,2,1,4,0,0,0,0,0,0
Metan Medias,47,40,35,122,150,126,27,39,54,120,106,155
Anzhi,18,19,34,71,72,99,14,15,41,70,50,114
Saprissa,3,1,2,6,9,8,0,2,3,5,3,13
Harrowby United,0,0,1,1,0,1,0,0,2,2,2,10
Dunkerque,1,1,5,7,11,15,1,0,3,4,1,5
Salmrohr,0,0,2,2,0,11,0,0,0,0,0,0
Ferencvaros,100,32,12,144,304,115,70,41,34,145,226,150
Arles-Avignon,1,1,1,3,3,4,2,0,2,4,6,9
Larne,16,11,6,33,62,29,17,7,9,33,58,37
Sierra Leone,7,1,2,10,11,9,0,1,7,8,5,18
Potters Bar,15,12,20,47,64,58,16,11,26,53,66,89
Sainte-Genevieve,0,0,1,1,0,3,0,0,0,0,0,0
Lichfield City,1,0,1,2,4,5,0,0,1,1,1,3
Boston Utd,74,31,43,148,267,193,56,38,61,155,214,225
Accrington,91,52,54,197,322,257,66,47,79,192,223,268
Belgium,40,8,2,50,155,37,25,4,7,36,78,33
Denizlispor,9,8,19,36,30,48,6,10,20,36,37,68
EF Reims Sainte-Anne,0,0,1,1,0,1,0,0,0,0,0,0
Ringwood Town,0,0,1,1,1,3,0,0,1,1,1,3
Silkeborg,18,13,34,65,87,118,9,19,37,65,60,114
Enosis,1,1,3,5,6,13,0,1,2,3,0,8
Wolfsberger,55,36,45,136,191,182,44,23,71,138,167,223
TuS Erndtebruck,0,0,3,3,3,13,0,0,0,0,0,0
Madagascar,4,9,4,17,21,28,8,5,7,20,25,21
Irlam FC,4,0,4,8,14,14,0,0,1,1,1,3
US Chantilly,0,0,1,1,0,4,0,0,0,0,0,0
Llanera,0,0,1,1,0,5,0,0,0,0,0,0
Shifnal T,0,0,1,1,1,4,0,0,1,1,0,6
Navalvcarnero,0,0,0,0,0,0,1,0,0,1,3,2
Notts Co,81,48,58,187,278,230,57,43,92,192,228,333
Shaw Lane,25,6,8,39,89,51,12,4,11,27,42,51
Arandina,0,0,1,1,2,4,1,0,0,1,8,2
Exeter,92,54,59,205,306,232,72,46,74,192,259,278
Elburton Villa,0,0,0,0,0,0,0,0,1,1,0,2
Liffre,0,0,1,1,1,4,0,0,0,0,0,0
St Neots,52,22,38,112,209,191,28,40,42,110,162,185
Gubbio,1,0,0,1,1,0,0,1,1,2,3,4
Bootle,0,0,2,2,2,7,3,0,3,6,17,15
Concordia C,25,36,43,104,105,135,25,25,56,106,103,167
Juvenes,0,0,1,1,0,2,1,1,3,5,4,16
Eton Manor,0,0,1,1,0,1,0,0,0,0,0,0
Sarre Union,1,1,4,6,3,10,1,0,2,3,6,8
Kazakhstan U21,0,0,1,1,0,1,0,0,0,0,0,0
Agro,0,0,1,1,1,5,0,0,0,0,0,0
Chessington & H,1,0,0,1,2,1,0,0,1,1,1,5
Agde,0,0,0,0,0,0,1,0,0,1,3,2
AR Sao Martinho,0,0,1,1,2,3,0,0,0,0,0,0
JJK Jyvaskyla,4,3,9,16,16,33,2,5,10,17,16,30
Vicenza,7,2,2,11,25,16,2,2,8,12,13,23
Giana Erminio,0,1,1,2,2,4,1,0,2,3,1,5
Hertha Berlin,52,35,47,134,178,197,40,36,69,145,182,222
Crumlin U,1,0,1,2,4,4,1,0,0,1,2,1
Andratx,0,0,0,0,0,0,0,0,1,1,0,3
Marignane,2,3,0,5,8,4,2,0,2,4,4,5
SV Linx,0,0,1,1,1,2,0,0,0,0,0,0
Skelmersdale,34,15,40,89,132,161,20,21,47,88,100,171
AEK Athens,73,27,25,125,222,103,58,34,35,127,160,117
Barkingside,0,1,1,2,4,6,0,0,1,1,0,5
Steeton,0,0,1,1,2,3,0,0,0,0,0,0
Messina,0,0,0,0,0,0,1,0,2,3,4,5
Ferrol,3,1,1,5,9,4,0,0,4,4,3,11
Norwich,85,42,49,176,303,210,64,43,78,185,226,279
Badalona,4,3,1,8,13,7,0,1,4,5,3,8
Newark Flowserve,2,1,0,3,6,2,2,0,1,3,8,9
Budafoki MTE,0,0,2,2,3,6,0,0,0,0,0,0
KI Klakksvik (DO NOT USE),2,1,1,4,14,8,1,0,1,2,2,2
Stirling Univ,21,11,24,56,85,98,21,11,30,62,87,113
Oleiros,0,0,1,1,2,4,0,0,0,0,0,0
Vietnam,6,4,4,14,17,15,4,3,4,11,16,14
FC Romania,2,1,2,5,6,4,3,1,4,8,14,16
South Sudan,2,3,3,8,12,13,1,0,8,9,3,24
Randers Freja,53,34,39,126,168,134,38,33,57,128,145,181
Arka Gdynia,27,23,25,75,104,94,15,19,42,76,78,127
Littlehampton T,2,3,1,6,20,15,1,1,1,3,8,7
KF Drita,1,1,2,4,3,8,3,1,4,8,10,11
Minai,4,2,8,14,12,24,0,4,9,13,5,26
Sp. Gijon,78,41,42,161,229,163,40,55,69,164,140,198
Wiltz,1,1,1,3,7,8,0,1,0,1,1,1
Finland,15,9,8,32,43,23,12,6,23,41,34,61
Amkar Perm,25,17,26,68,62,63,10,25,29,64,47,83
Carterton,0,0,0,0,0,0,1,0,1,2,5,5
Pickering Town,3,3,4,10,13,20,3,2,2,7,10,11
Ghana,20,11,7,38,67,29,12,12,14,38,38,38
Como,2,1,0,3,9,1,0,1,6,7,2,16
Belgium U21,1,0,1,2,3,4,4,1,4,9,19,14
Terrassa,0,0,1,1,2,4,0,0,0,0,0,0
Ekranas,2,0,2,4,6,7,0,0,4,4,1,8
Japan,39,11,14,64,135,67,16,6,7,29,61,24
Brandon United,0,0,0,0,0,0,0,0,1,1,0,8
Leiknir Reykjavik,0,0,0,0,0,0,0,0,2,2,0,2
AOX Kissamikos,0,1,0,1,1,1,0,0,0,0,0,0
Belenenses,43,41,47,131,141,169,31,44,58,133,103,187
Coleshill,6,1,4,11,33,31,7,1,5,13,26,32
Vitosha Bistritsa,8,10,28,46,40,80,4,7,36,47,18,86
Linares,1,0,3,4,3,6,1,1,1,3,7,5
Olsa Brakel,0,0,0,0,0,0,0,0,1,1,1,6
SK Tirana,2,2,3,7,8,9,1,2,6,9,8,16
Atvidabergs,9,11,10,30,42,44,5,5,20,30,22,57
Albacete,49,42,40,131,147,133,33,31,68,132,115,189
Ross County U21,0,0,1,1,2,3,1,0,0,1,3,2
Kenya,15,7,5,27,30,20,2,5,11,18,10,22
FK Baku,0,1,1,2,2,4,0,1,3,4,3,9
Switzerland Women,0,0,0,0,0,0,0,0,1,1,1,3
Ecuador,16,6,9,31,64,39,11,8,19,38,50,56
S'derland U23,2,0,1,3,7,5,4,3,1,8,10,8
Milsami Orhei,9,2,8,19,31,24,4,1,10,15,11,26
Selston,0,0,0,0,0,0,0,0,1,1,0,3
Fiji,5,3,3,11,26,12,1,5,7,13,10,18
Uzbekistan,22,5,11,38,50,27,8,5,14,27,34,36
Kryliya Sovetov,14,22,31,67,58,83,19,9,39,67,61,100
Hemsworth Miners Welfare,1,0,1,2,4,7,2,0,4,6,7,15
HNK Gorica,23,16,14,53,80,62,23,13,16,52,80,70
Milan,98,39,41,178,296,179,70,48,50,168,241,208
Trelleborgs,2,2,11,15,12,33,1,4,11,16,12,34
De Graafschap,9,9,16,34,48,57,4,4,26,34,29,84
Veris,2,2,0,4,7,4,2,1,2,5,4,4
Swallownest,0,1,0,1,1,1,0,0,0,0,0,0
V Reykjavik,0,1,3,4,3,10,0,1,3,4,2,9
San Giovanni,0,0,0,0,0,0,0,0,1,1,3,5
R-Weiss Essen,5,3,3,11,16,17,0,1,1,2,0,3
AC Houilles,0,0,1,1,0,3,0,0,0,0,0,0
Burton,81,43,68,192,247,240,64,53,73,190,221,269
Wells City,0,1,1,2,3,4,0,0,1,1,0,2
Prestwich Heys,1,1,0,2,6,2,0,0,1,1,0,1
Abbey Hey,1,0,1,2,3,6,0,0,2,2,0,3
Huracan Val,1,0,0,1,2,0,0,0,1,1,0,1
Brazil Olympic,2,3,0,5,9,1,1,0,0,1,4,0
Poland,26,11,10,47,93,43,13,9,6,28,49,29
Altrincham,76,44,55,175,307,230,65,41,76,182,246,270
Karlskrona,0,1,1,2,2,3,0,0,1,1,1,5
FK Trakai,13,3,1,17,36,10,9,3,7,19,31,24
Virtus Entella,6,2,4,12,16,9,2,5,8,15,11,27
Baffins Milton R,3,0,1,4,9,6,2,0,2,4,7,9
Chartres,0,0,1,1,1,2,1,1,0,2,4,1
Buckland Ath,4,0,5,9,12,17,9,0,1,10,26,9
Pirmasens,0,0,2,2,2,7,0,0,1,1,0,1
Hornchurch,38,26,24,88,152,100,30,22,40,92,132,137
Proleter Novi Sad,19,14,18,51,58,49,11,14,27,52,39,81
Antequera,1,0,0,1,2,0,0,0,1,1,1,3
Amesbury T,0,0,1,1,0,1,0,0,0,0,0,0
Gillingham,82,50,62,194,285,248,55,56,84,195,231,305
Kelty Hearts,27,9,6,42,132,36,27,3,8,38,83,37
Faroe Isl U21,0,0,0,0,0,0,0,0,1,1,0,3
Besa,0,0,1,1,0,2,0,0,1,1,0,1
Smolevichi-STI,7,7,18,32,35,62,4,9,19,32,24,51
Concarneau,4,2,4,10,13,12,3,3,1,7,10,5
East Preston,1,0,2,3,4,10,0,0,1,1,0,4
Municipal,1,0,1,2,6,7,0,1,1,2,2,5
Synot,51,29,36,116,168,124,31,32,54,117,119,176
Ilves Tampere,43,28,21,92,119,86,35,20,38,93,109,133
Culter,1,0,0,1,4,2,0,0,1,1,1,7
Spartak Semey,0,1,0,1,1,1,0,0,0,0,0,0
TuS Rot-Weiss Koblenz,0,0,2,2,1,8,0,0,1,1,0,7
Cordoba,47,34,49,130,165,170,34,32,63,129,130,205
Le Mee,0,0,0,0,0,0,1,0,0,1,2,0
Cagliari,57,27,56,140,207,211,28,36,74,138,132,232
Ponsacco,0,0,0,0,0,0,0,0,1,1,1,4
Burghausen,0,0,0,0,0,0,1,0,0,1,1,0
ACS Poli,0,0,2,2,0,6,1,0,0,1,3,1
Loko. Sofia,14,6,4,24,34,14,11,3,9,23,28,29
Nantes II,0,1,0,1,0,0,0,0,3,3,2,7
RC Warwick,1,0,0,1,3,2,0,0,0,0,0,0
Gibraltar Phoenix,0,0,1,1,0,2,0,0,1,1,0,3
FC Zimbru,6,4,4,14,15,9,5,2,10,17,19,31
Sun Sports,2,1,2,5,7,8,1,1,0,2,4,2
Hamrun Spar,1,1,0,2,3,2,0,1,0,1,1,1
Walsall,72,55,75,202,253,265,56,64,70,190,211,248
M Saransk,10,8,12,30,27,31,5,9,16,30,25,62
CP Cosmos,0,0,4,4,4,10,0,0,0,0,0,0
Romorantin,4,0,4,8,12,10,2,2,0,4,5,2
Ebro,4,3,4,11,12,11,2,3,3,8,7,9
Crotone,28,19,31,78,101,104,11,10,56,77,70,167
Pau,3,5,3,11,11,11,1,4,2,7,4,11
Armenia,14,7,11,32,54,47,6,4,19,29,34,66
Wingate & F,63,31,59,153,226,218,53,27,83,163,216,306
New Star,0,0,1,1,1,2,0,0,0,0,0,0
Alfreton,44,46,60,150,220,244,46,25,81,152,190,291
Albinoleffe,0,1,2,3,1,3,2,0,2,4,7,6
Turkey,21,10,8,39,61,38,17,12,10,39,60,46
Poggibonsi,0,0,0,0,0,0,0,0,1,1,0,3
Wohlen,0,0,1,1,1,3,0,0,1,1,0,3
Blagnac,1,0,1,2,2,2,0,0,0,0,0,0
Camelon Jnrs,4,0,1,5,21,6,5,1,0,6,23,11
Kaunas,0,0,1,1,0,3,0,0,0,0,0,0
Dunaujvaros,4,5,6,15,13,18,1,3,11,15,13,31
Reims,42,35,34,111,130,126,28,34,50,112,123,172
Aldershot,71,45,62,178,232,207,53,46,82,181,208,283
Ely City,1,0,1,2,3,3,3,0,1,4,10,7
Lip. Stiavnica,0,0,1,1,0,4,0,0,0,0,0,0
Laos,0,1,5,6,3,15,1,2,7,10,4,32
Parma,33,21,41,95,108,126,21,21,51,93,120,184
Petrocub,3,1,3,7,7,7,0,0,5,5,2,11
Sutton Common Rovers,7,0,2,9,25,13,4,2,4,10,20,23
Wellington AFC,1,0,0,1,6,4,0,0,1,1,1,2
Margate,57,36,60,153,214,234,52,37,60,149,201,201
Luneville,0,0,2,2,1,4,0,0,0,0,0,0
Lancaster,27,27,21,75,99,91,24,18,32,74,107,130
Fabregues,0,0,3,3,1,7,0,0,1,1,0,2
Walsham Le Willows,1,0,1,2,5,2,0,0,1,1,1,2
Auckland City,0,0,0,0,0,0,1,2,4,7,4,8
Keshla,1,1,0,2,2,1,0,0,1,1,1,4
FV Illertissen,0,0,1,1,2,3,0,1,0,1,0,0
Coggeshall T,0,1,0,1,1,1,0,1,2,3,1,4
Cowdenbeath,51,24,75,150,172,230,32,33,84,149,144,277
Energetyk-BDU,10,10,15,35,56,62,10,7,16,33,46,59
Torpoint Ath,1,0,2,3,2,5,2,0,2,4,7,5
Bracknell,5,1,2,8,24,12,4,2,2,8,20,17
Ireland U21,0,0,0,0,0,0,0,0,1,1,0,2
Clydebank,0,0,0,0,0,0,0,0,1,1,0,4
Greuther Furth II,1,0,0,1,2,1,0,0,0,0,0,0
Andorra U21,0,0,0,0,0,0,0,0,2,2,0,10
Man City U21,3,4,2,9,15,12,11,7,12,30,58,50
Melfi,0,0,0,0,0,0,0,0,1,1,0,2
Monaco,103,43,37,183,347,192,86,42,57,185,293,257
Folland Sports,1,0,1,2,4,4,0,0,0,0,0,0
Pontedera,1,0,1,2,4,3,0,1,4,5,4,9
Nostell M W,0,0,1,1,0,2,0,0,0,0,0,0
Comoros,3,6,1,10,12,9,0,7,9,16,11,27
Barnoldswick,0,0,0,0,0,0,1,0,2,3,6,7
Gazisehir,16,13,7,36,63,40,9,13,14,36,40,56
Aberdeen U20,1,0,3,4,5,10,1,0,3,4,7,13
Belper United,0,0,1,1,1,4,0,0,2,2,3,5
Dominican Rep,2,1,3,6,9,7,2,0,4,6,8,10
Mulbarton Wanderers,3,1,0,4,10,0,0,0,0,0,0,0
Cameroon,17,15,8,40,46,32,13,17,9,39,45,45
Kastrioti Kruje,0,0,1,1,1,3,0,0,1,1,0,6
Dag & Red,67,47,67,181,240,235,63,33,85,181,218,248
Genk,97,33,33,163,313,163,62,44,60,166,245,242
Rylands,3,1,1,5,7,2,1,2,0,3,3,2
FSV Union Furstenwalde,0,0,1,1,1,4,0,0,0,0,0,0
Germany,32,17,9,58,136,60,21,4,8,33,64,33
Lugo,68,50,42,160,199,171,27,62,77,166,130,229
ES Tunis,0,1,0,1,1,1,1,0,1,2,6,3
Tom Tomsk,8,4,11,23,22,40,1,5,17,23,8,42
Wettswil-B,0,0,1,1,0,2,0,0,0,0,0,0
Hamworthy United,3,0,1,4,14,6,2,1,2,5,10,6
Oravska Poruba,0,0,1,1,0,7,0,0,0,0,0,0
Ontinyent,0,1,1,2,1,2,1,0,2,3,4,4
Schiltigheim,1,0,3,4,5,14,0,0,0,0,0,0
Mornar,0,0,0,0,0,0,1,0,1,2,2,3
Barwell,51,25,35,111,165,133,43,26,45,114,173,180
Cambridge U,84,48,67,199,280,229,61,45,88,194,219,268
Sparta Prague,109,19,19,147,337,124,54,44,46,144,195,164
Grbalj,0,0,0,0,0,0,1,0,3,4,3,6
Lille II,0,0,0,0,0,0,0,1,0,1,0,0
Cork City,78,25,28,131,243,107,61,29,42,132,176,138
Jarrow Roofing,0,0,1,1,1,3,0,0,1,1,0,5
West Didsbury & Chorlton AFC,0,0,3,3,5,10,0,0,1,1,0,2
Barrow Town,0,0,2,2,1,3,0,0,0,0,0,0
Ash Utd,0,0,1,1,0,4,0,0,0,0,0,0
Monterrey,6,2,1,9,22,8,3,2,1,6,11,5
MS Ashdod,32,39,37,108,122,132,27,30,52,109,106,162
Liechtenstein U21,0,0,1,1,1,7,0,0,1,1,0,4
Halesowen,38,34,31,103,137,131,32,25,51,108,115,162
UCD,52,20,39,111,187,154,35,27,51,113,161,189
Iceland,19,5,12,36,49,36,15,10,26,51,66,93
Derry City,55,28,46,129,190,148,39,35,51,125,153,184
R Majadahonda,9,8,10,27,27,29,5,3,16,24,25,42
Tre Penne,6,4,7,17,20,26,7,1,5,13,21,23
Compostela,0,0,0,0,0,0,1,0,3,4,6,6
Parnu,0,0,0,0,0,0,0,1,1,2,1,3
Bilbao Athletic,6,6,9,21,20,22,2,2,17,21,15,37
Torpedo Mosc.,3,6,6,15,14,19,3,5,9,17,15,33
MFK Karvina,25,25,30,80,98,101,14,18,49,81,74,144
Lorca,8,7,10,25,31,38,2,4,17,23,17,43
Clacton,2,0,1,3,5,4,2,1,3,6,12,18
Keciorengucu,0,0,1,1,1,2,0,0,0,0,0,0
Levante II,0,0,0,0,0,0,0,0,1,1,0,1
Pontivy,0,0,1,1,0,4,0,0,0,0,0,0
Hapoel Ra'ana,29,33,48,110,102,146,27,33,50,110,103,150
Turks & Caicos,0,0,3,3,2,21,0,0,3,3,2,22
Girvan,0,0,1,1,1,2,0,0,2,2,1,8
VfB Eichstatt,0,0,1,1,1,5,0,0,0,0,0,0
Virgin Isl. (US),0,0,4,4,0,20,1,0,2,3,1,8
Ironi Ramat Ha,1,1,6,8,7,15,6,1,3,10,14,16
Wegberg-Beeck,0,0,1,1,0,2,0,0,1,1,2,3
Sud Nivernais Imphy-Decize Sn,0,0,0,0,0,0,0,0,1,1,1,3
Rebecq,0,0,0,0,0,0,0,0,1,1,0,3
Leixoes,1,0,0,1,1,0,0,0,1,1,2,6
V Guimaraes,66,36,38,140,208,145,45,33,64,142,177,210
Ki Klaksvik,6,2,4,12,21,13,5,4,5,14,20,22
Leighton,7,1,3,11,31,19,8,1,4,13,27,30
Dover,80,41,54,175,274,200,68,42,64,174,244,254
Silsden,1,0,1,2,5,5,0,1,2,3,3,7
IK Brage,1,0,1,2,3,3,0,2,1,3,5,8
Buckingham T,0,0,0,0,0,0,0,0,1,1,4,5
Philippines,6,5,8,19,29,33,4,4,11,19,17,31
Darlington,66,23,35,124,228,141,45,31,43,119,192,191
Moldova U21,0,0,1,1,0,3,0,0,2,2,1,8
Boston Town,0,0,1,1,2,3,0,0,0,0,0,0
Saint-Lo Manche,0,0,0,0,0,0,0,1,0,1,1,1
Oman,12,5,6,23,41,25,7,5,13,25,22,37
Atherstone T,2,1,2,5,15,8,2,2,1,5,11,6
Melbourne C,59,21,20,100,194,112,33,20,51,104,165,175
Chiasso,0,0,2,2,1,4,0,0,0,0,0,0
MyPa-47,9,8,2,19,35,23,2,3,13,18,7,34
Tunisia,19,10,7,36,54,27,14,11,10,35,44,36
Hercules,5,6,8,19,20,22,3,6,8,17,17,32
Blackstones,0,0,1,1,2,4,0,0,0,0,0,0
B Dortmund,114,35,30,179,428,195,94,37,57,188,348,248
Karmiotissa,0,0,1,1,0,1,0,0,0,0,0,0
Leith Athletic,1,1,0,2,4,1,0,0,1,1,0,1
Asco,0,0,0,0,0,0,0,0,1,1,0,2
Brimscombe & Thrupp,2,2,2,6,13,13,3,1,3,7,7,13
Urraca,0,0,0,0,0,0,0,0,1,1,0,1
Cradley Town,0,0,0,0,0,0,0,0,1,1,0,1
PEC Zwolle,51,31,41,123,209,182,29,27,70,126,134,233
IBV Vestmann,3,0,3,6,7,9,0,0,4,4,2,11
Veroia,18,18,20,56,63,66,10,14,31,55,41,100
Whittlesey Athletic,0,0,1,1,0,6,0,0,0,0,0,0
Nordsjaelland,60,29,42,131,219,175,38,33,59,130,176,215
Toluca,0,0,1,1,0,2,0,0,1,1,0,3
Sevilla,145,35,32,212,418,186,86,52,80,218,313,310
Dnipro-1,14,3,11,28,46,32,7,7,15,29,33,52
Slavia Prague,97,32,20,149,304,116,67,37,41,145,225,148
SV Alemannia W,0,0,1,1,0,6,0,0,0,0,0,0
Longridge Town,4,1,3,8,19,13,0,1,0,1,3,3
Arsenal Kiev,2,5,9,16,15,32,5,0,11,16,11,24
Montenegro U21,0,0,2,2,1,5,0,0,2,2,0,8
Blanc Mesnil,0,0,1,1,0,2,0,0,0,0,0,0
SSEP Hombourg-Haut,0,1,1,2,1,4,0,0,0,0,0,0
Northwood,1,4,3,8,14,20,2,1,3,6,11,13
Canada,16,6,3,25,58,18,9,8,11,28,50,33
Wulfrunians,1,2,1,4,9,6,2,0,3,5,6,13
Winterthur,0,0,0,0,0,0,1,0,0,1,1,0
B Munich,145,23,15,183,546,150,141,29,31,201,461,184
Biel-Bienne,1,0,1,2,4,4,0,0,0,0,0,0
Thor SC,1,0,0,1,2,0,0,1,1,2,2,3
Sireti,0,0,1,1,0,15,0,0,1,1,0,12
Swindon Sup.,23,10,15,48,82,67,19,8,20,47,68,75
B. Banja Luka,2,0,2,4,2,4,0,0,2,2,2,7
Harrogate (old),0,0,1,1,1,2,0,0,0,0,0,0
Fiorentina,75,54,47,176,275,200,62,43,62,167,240,230
Loughbr'gh Un,1,1,1,3,5,2,1,0,3,4,12,12
Carrick Rangers,18,20,54,92,98,166,19,16,59,94,84,196
U'horster SC P,0,0,1,1,0,9,0,0,0,0,0,0
SV Horn,0,0,0,0,0,0,0,0,1,1,0,3
Inhulets Petrove,3,8,2,13,11,13,2,3,8,13,13,26
Teruel,0,0,1,1,2,3,1,0,2,3,3,4
Clermont,7,3,5,15,23,15,11,5,10,26,41,36
S C Espinho,0,0,1,1,0,5,0,0,0,0,0,0
Bahlinger SC,0,2,1,3,5,6,0,0,0,0,0,0
Hekimoglu Trabzon,0,0,1,1,0,1,0,0,0,0,0,0
Tondela,33,20,47,100,110,139,21,25,55,101,97,165
Victoria Wand,0,0,1,1,1,3,0,0,0,0,0,0
AFC Uckfield Town,2,0,2,4,13,12,4,0,1,5,11,9
Venissieux,0,0,1,1,0,1,0,0,0,0,0,0
Thrapston T,0,0,1,1,3,7,0,0,0,0,0,0
Deportivo B,0,0,0,0,0,0,1,1,0,2,1,0
Rushden,1,0,1,2,2,1,0,1,1,2,2,4
Warminster Town,2,0,0,2,6,3,1,0,1,2,3,4
Chateauroux,8,6,8,22,30,31,6,3,9,18,21,31
Congleton Town,3,2,3,8,16,15,1,1,3,5,5,9
Midtjylland,102,21,31,154,322,153,71,34,46,151,240,198
Brescia,13,10,16,39,55,56,7,5,20,32,26,60
Asteras T.,66,42,27,135,192,123,29,38,68,135,122,189
Helsingborgs,28,16,31,75,97,96,14,19,42,75,83,142
Mboro U23,1,1,2,4,3,6,1,1,4,6,6,10
Northern Mariana Islands,0,0,1,1,0,8,0,0,1,1,0,5
Hamilton U20,3,3,2,8,14,9,3,1,2,6,11,7
AFC Totton,6,4,8,18,30,37,6,6,9,21,32,43
Fatih Karagumruk,11,4,5,20,38,23,3,8,8,19,20,31
LA Galaxy,47,22,27,96,175,133,24,25,44,93,131,181
Jeonbuk H M,1,0,1,2,5,3,0,0,0,0,0,0
Cheltenham,91,50,59,200,308,237,58,51,80,189,213,253
Dominica,1,1,3,5,3,9,1,0,3,4,3,12
Zeta,4,3,1,8,12,8,3,1,2,6,7,5
Ivory Coast Women,0,1,0,1,1,1,0,0,0,0,0,0
Sherborne Town,0,0,0,0,0,0,0,0,3,3,2,9
Ethnikos Akhna,0,1,3,4,4,10,0,0,3,3,0,9
Bonner SC,0,0,1,1,2,6,0,0,1,1,0,2
Argentina Women,1,1,2,4,3,8,0,2,2,4,4,8
Long Buckby,0,0,0,0,0,0,1,0,1,2,4,4
Widzew Lodz,3,4,0,7,10,6,0,3,6,9,7,16
Mali,12,6,6,24,36,18,7,15,14,36,37,49
Hostert,1,0,2,3,5,10,0,0,3,3,4,13
S. Bratislava,38,7,11,56,111,56,28,10,24,62,109,94
Sweden U21,1,3,4,8,5,11,4,4,1,9,21,11
Ossett United,3,0,1,4,9,3,0,0,2,2,2,4
Zalgiris Vilnius,13,4,3,20,33,14,8,7,9,24,34,28
Renova,1,2,4,7,12,19,1,1,7,9,6,24
Correggese,0,0,0,0,0,0,0,0,1,1,0,2
UAE,19,9,6,34,68,27,7,9,13,29,23,38
FC Magdeburg,10,12,10,32,38,37,9,5,12,26,31,44
Thackley,0,0,1,1,0,1,1,0,0,1,4,1
Alashkert,12,3,8,23,37,29,10,8,9,27,35,37
Gedling Miners Welfare,0,0,1,1,0,2,0,0,0,0,0,0
Helston Athletic,0,0,3,3,2,9,0,1,0,1,2,2
Guadeloupe,0,0,2,2,0,2,0,0,2,2,0,8
Dudley Town,0,0,0,0,0,0,1,0,1,2,4,3
Norwich U23,2,1,5,8,7,10,3,0,1,4,12,3
Targu Mures,22,19,15,56,56,53,14,14,28,56,55,76
FC Sheriff,32,13,8,53,119,37,30,11,11,52,103,38
Folgore Falciano,1,2,5,8,7,12,3,2,10,15,10,23
Independiente La Chorrera,2,0,0,2,6,1,0,1,1,2,1,4
Aylestone Park,0,1,1,2,3,6,0,0,1,1,1,4
Cova Piedade,0,0,1,1,0,4,0,0,0,0,0,0
Bristol Manor F,9,1,0,10,34,7,3,0,7,10,16,20
Real Betis,74,40,50,164,243,212,52,40,74,166,191,255
CPBB Rennes,0,0,1,1,1,4,0,0,0,0,0,0
RB Leipzig,80,30,23,133,257,138,68,30,37,135,241,169
Metalurg R.,0,0,1,1,0,2,0,0,2,2,2,9
St Martin,0,0,0,0,0,0,0,0,1,1,0,13
Dinamo Tbilisi,12,2,5,19,33,17,8,2,10,20,27,32
Steenvoorde,0,0,1,1,2,4,0,0,0,0,0,0
Slavija,0,0,1,1,2,3,0,0,1,1,0,1
Jeanne d'Arc,0,0,1,1,0,6,0,0,0,0,0,0
Sanf Hiroshima,2,0,1,3,4,2,1,0,0,1,3,0
Sportfreunde L,4,1,7,12,11,19,4,2,2,8,13,10
Sheerwater,0,0,0,0,0,0,0,0,2,2,0,7
Zestafoni,1,2,0,3,3,2,1,0,2,3,3,8
Metalac,19,23,13,55,70,57,12,14,29,55,44,81
Clyde,70,29,51,150,244,210,57,24,77,158,192,239
Blackburn U21,4,1,1,6,15,6,3,1,0,4,10,5
AFC Sudbury,14,7,12,33,57,51,11,9,19,39,51,71
Decic Tuzi,0,1,0,1,0,0,0,0,7,7,3,22
Ramsbottom,18,15,27,60,95,106,17,14,32,63,83,138
FCD Annecy,0,0,3,3,2,9,2,3,1,6,8,6
Espanyol,78,39,49,166,229,182,45,47,78,170,178,244
Coleraine,70,44,30,144,223,149,66,28,46,140,214,176
Biggleswade,2,1,0,3,5,2,1,3,4,8,11,14
SC Hauenstein,0,0,1,1,1,2,0,0,0,0,0,0
Limerick,41,19,42,102,150,149,33,19,48,100,129,185
W Beveren,37,31,69,137,165,235,29,33,74,136,162,268
Saffron Dynamo,0,1,0,1,3,3,1,0,1,2,3,5
Broadbridge H,1,0,0,1,3,0,0,0,1,1,2,8
Ebbsfleet,83,40,44,167,284,178,71,50,50,171,236,200
W Bremen,49,36,51,136,192,203,48,36,61,145,226,261
Ahrobiznes Volochysk,1,0,0,1,1,0,0,0,0,0,0,0
Royal W Bassett T,2,0,0,2,6,1,0,0,2,2,3,5
Olympiakos Nic.,1,1,0,2,2,1,0,0,1,1,1,6
Maribor,88,48,24,160,291,157,89,40,34,163,299,166
RM Hamm Benfica,0,0,2,2,3,8,0,0,4,4,8,18
Nantes,62,38,54,154,193,181,44,39,70,153,154,208
Europa Point,0,0,0,0,0,0,0,0,2,2,0,18
Shrewsbury,91,53,62,206,278,224,64,53,85,202,216,265
Bromley,84,38,59,181,310,239,63,45,69,177,249,265
Harrogate R,0,0,3,3,3,6,0,0,3,3,2,13
Gosport Bor,55,32,62,149,208,264,45,28,79,152,175,258
West Allotment,0,0,1,1,2,4,0,0,1,1,3,7
Cheddar,2,0,1,3,5,3,0,0,1,1,1,6
Foggia,2,0,2,4,8,8,2,2,5,9,11,16
Ivancsa,0,0,1,1,0,3,0,0,0,0,0,0
Tomares,1,0,1,2,3,6,0,0,0,0,0,0
Noah,0,0,1,1,1,2,0,0,2,2,1,6
Peebles Rovers,0,0,0,0,0,0,0,0,1,1,1,3
Matelica,0,0,0,0,0,0,0,0,4,4,0,9
Switzerland,25,10,6,41,89,35,17,6,14,37,55,41
Andrezieux,3,0,3,6,10,6,2,0,1,3,4,3
Kletsk,0,1,0,1,2,2,0,0,0,0,0,0
Apolonia Fier,0,0,0,0,0,0,0,0,1,1,1,2
Eldense,0,0,0,0,0,0,0,2,0,2,4,4
Royston,29,5,8,42,105,48,14,7,17,38,55,58
Elche,51,56,39,146,160,160,37,42,73,152,149,237
AGF,0,0,0,0,0,0,0,0,1,1,2,3
Torquay,74,37,65,176,266,227,64,38,79,181,231,251
Kaiserslautern,21,23,19,63,70,68,19,13,36,68,94,120
Portugal Olympic,1,0,1,2,2,4,1,1,0,2,3,2
AC London,0,1,0,1,4,4,0,0,1,1,1,2
Fleet Town,2,1,3,6,6,10,1,0,3,4,4,10
Alvechurch,0,1,2,3,3,8,5,0,4,9,15,10
Sabail,0,0,1,1,2,3,0,0,1,1,2,3
Umraniyespor,1,0,0,1,1,0,1,0,0,1,1,0
Lesotho,3,7,4,14,10,12,2,6,6,14,7,22
Anagennisis,0,0,0,0,0,0,0,0,1,1,0,2
Kauno Zalgiris,2,1,2,5,6,5,0,0,4,4,2,17
Lothian Hutchison,0,0,0,0,0,0,0,0,1,1,1,4
B'ham U23,0,0,1,1,1,3,0,0,0,0,0,0
Alton Town,0,0,1,1,0,2,0,0,2,2,2,7
N'castle U21,4,3,5,12,26,21,6,2,14,22,26,49
Chinnor,0,0,0,0,0,0,0,0,1,1,1,2
Celta Vigo B,0,0,0,0,0,0,1,0,1,2,2,3
Thailand Women,0,0,1,1,0,2,0,0,6,6,3,34
Hrvatski D.,4,1,3,8,15,12,2,1,5,8,11,16
Leek,5,2,5,12,23,20,5,2,3,10,25,19
Zaglebie Lubin,49,36,34,119,194,149,40,30,47,117,137,143
Brislington,0,0,0,0,0,0,0,0,1,1,1,2
Tyumen,0,1,0,1,1,1,0,0,0,0,0,0
Corona Brasov,0,4,3,7,4,13,0,0,8,8,2,25
Villanovense,4,5,3,12,13,13,1,3,8,12,13,26
Taiwan,0,0,0,0,0,0,0,0,1,1,1,5
Volos NFC,12,10,11,33,33,35,6,10,16,32,28,55
Turnovo,2,1,2,5,3,6,1,0,3,4,6,10
Spartak Nalchik,0,0,0,0,0,0,0,0,1,1,2,5
Met. Police,78,33,47,158,257,208,48,37,64,149,216,248
Vlasim,0,1,0,1,1,1,0,0,0,0,0,0
Blantyre,0,0,1,1,0,4,0,0,0,0,0,0
Reading Town,0,0,0,0,0,0,0,0,1,1,1,2
Celtic,160,28,26,214,537,142,129,43,40,212,422,211
S Karagandy,8,2,2,12,26,13,1,1,8,10,7,23
Tooting & M Wan,0,0,0,0,0,0,0,0,1,1,0,9
Evian,13,7,16,36,40,44,10,8,24,42,43,62
Poissy,0,0,1,1,0,1,0,0,2,2,0,4
Concord R,57,41,54,152,233,211,52,38,61,151,201,226
Russia U21,1,0,2,3,5,5,0,0,3,3,5,10
Hobro IK,25,26,31,82,101,118,15,22,46,83,79,145
Panathinaikos,91,29,26,146,249,111,45,48,54,147,150,170
U da Madeira,6,6,5,17,19,17,1,2,14,17,8,33
Arda,13,8,7,28,37,33,8,12,10,30,29,33
Central Africa,3,2,2,7,9,7,0,2,6,8,4,23
Sileks,0,2,5,7,5,13,0,2,3,5,2,10
At Saguntino,0,2,0,2,2,2,1,0,0,1,1,0
MOIK,0,0,0,0,0,0,0,0,1,1,2,4
Evesham,5,4,4,13,19,19,1,2,3,6,3,7
Panachaiki,0,0,1,1,0,2,0,0,0,0,0,0
Pieta,0,0,0,0,0,0,1,0,0,1,3,0
Huesca,59,33,37,129,180,145,33,41,58,132,139,191
Tonbridge,72,39,51,162,269,218,54,39,68,161,192,225
Real Valladolid II,0,1,1,2,0,1,0,1,0,1,1,1
Dynamo Berlin,0,0,3,3,1,13,0,0,0,0,0,0
Dalbeattie Star,11,12,29,52,62,99,7,8,37,52,62,150
Morton,68,44,44,156,228,173,51,39,70,160,194,235
Fulham,75,39,71,185,270,262,57,52,72,181,221,276
Liverpool U23,2,0,1,3,8,4,0,0,1,1,1,2
Waregem,57,36,53,146,256,239,47,30,69,146,209,272
Burnley U23,0,0,0,0,0,0,1,0,1,2,4,5
Sanjoanense,0,0,1,1,0,4,0,0,0,0,0,0
Alpha Utd,0,0,0,0,0,0,0,0,2,2,0,12
Kadakas,0,0,1,1,0,8,0,0,0,0,0,0
Rudar Velenje,37,33,50,120,163,168,34,27,58,119,137,209
NK Radomlje,3,6,27,36,23,89,2,9,26,37,22,77
Real Madrid B,4,4,4,12,19,16,3,6,4,13,14,14
Rochdale,82,58,67,207,292,263,65,40,89,194,250,304
Kensington B,0,0,1,1,0,3,1,0,1,2,2,3
Fola Esch,14,2,7,23,53,31,7,6,14,27,41,53
Cukaricki,83,28,29,140,243,132,50,40,46,136,173,161
Atl Madrid,140,40,19,199,362,110,97,63,51,211,290,192
Sandefjord,18,15,27,60,71,84,10,12,39,61,69,135
Neman Grodno,39,27,43,109,119,116,40,27,42,109,112,130
Blackpool,78,55,60,193,263,227,46,62,91,199,198,276
Hanwell Town,4,1,4,9,17,13,2,1,3,6,6,10
CfR Pforzheim,1,0,1,2,4,3,0,0,0,0,0,0
Boca Juniors (Gib),0,0,0,0,0,0,0,0,1,1,0,10
Garliava,0,0,1,1,0,8,0,0,0,0,0,0
Coruxo,0,0,2,2,4,9,0,0,0,0,0,0
Wisbech St Mary,1,0,1,2,3,5,0,0,0,0,0,0
Haro Deportivo,1,0,3,4,5,8,1,0,0,1,1,0
AD Ceuta,0,1,1,2,1,5,0,0,1,1,0,2
Bedfont Sports,2,2,5,9,12,23,1,2,1,4,5,6
Guijuelo,3,0,3,6,3,8,2,0,4,6,11,12
Bergantinos,0,0,1,1,0,1,0,0,0,0,0,0
Thiers,0,0,0,0,0,0,0,0,1,1,0,2
Ukraine U-21,0,0,0,0,0,0,0,0,1,1,0,2
Dundee Utd,92,36,44,172,284,198,63,44,67,174,219,239
OFI Crete,28,17,30,75,88,96,12,16,49,77,58,139
G. Segoviana,1,0,3,4,2,5,1,0,0,1,2,1
Talavera CF,3,2,3,8,10,9,1,0,0,1,2,0
Hienghene Sport,0,0,0,0,0,0,0,0,1,1,1,3
Tooting & M,8,3,16,27,40,63,8,6,18,32,35,57
P Bielsko-Biala,20,21,19,60,78,87,14,15,30,59,65,109
Mosta,1,0,4,5,7,13,0,2,0,2,2,2
Bridon Ropes,0,0,0,0,0,0,0,0,2,2,3,5
SJK,56,23,35,114,154,113,31,34,43,108,104,124
B68 Toftir,0,0,1,1,1,3,0,0,2,2,1,6
Tarpeda,0,0,0,0,0,0,0,0,1,1,1,8
Cadbury Athletic,2,0,0,2,7,2,0,0,4,4,4,19
Nea Salamis,4,1,6,11,14,29,0,0,6,6,3,15
FK Rad 1923,3,11,8,22,16,30,4,3,15,22,13,36
Witham Town,8,8,13,29,40,46,4,8,18,30,33,64
Framlingham T,1,0,0,1,2,0,0,0,1,1,1,2
H. Petah Tikva,4,4,8,16,21,26,4,4,9,17,22,33
Strazske,0,0,1,1,0,9,0,0,0,0,0,0
Velez Mostar,2,0,0,2,5,2,0,1,2,3,1,3
Cleethorpes T,9,0,5,14,20,21,8,2,2,12,30,22
Le Poire/vie,2,1,4,7,9,16,3,1,0,4,5,1
Burnham R,0,0,2,2,1,6,0,0,0,0,0,0
Fasano,0,0,0,0,0,0,0,0,1,1,2,4
Barnstaple T,0,0,1,1,1,3,2,0,5,7,11,15
Selby Town,1,0,2,3,8,7,0,0,1,1,2,4
FC Viktoria 1889,0,0,2,2,0,3,0,0,0,0,0,0
Cribbs,1,1,1,3,5,6,5,0,3,8,21,13
Vitoria Setubal,34,37,41,112,116,131,17,32,64,113,97,200
Holyport,0,0,1,1,0,3,0,1,0,1,0,0
Iskra-Stal Ribnita,0,0,1,1,1,9,0,0,0,0,0,0
Libertas,2,0,3,5,9,6,0,2,2,4,0,6
Zorya,58,34,37,129,196,147,56,29,44,129,180,145
Varea,0,0,2,2,2,7,0,0,1,1,0,3
Dinan-Lehon FC,0,0,1,1,0,3,0,0,1,1,0,1
Lynx,0,0,2,2,1,5,0,0,4,4,1,14
Ajaccio II,0,0,1,1,0,2,0,0,0,0,0,0
Cambodia,2,1,9,12,8,29,1,1,7,9,6,36
Nancy II,1,0,0,1,2,1,0,0,0,0,0,0
Ashby Ivanhoe,0,0,1,1,3,5,0,0,0,0,0,0
Almondsbury T,1,0,1,2,3,3,0,0,0,0,0,0
Krka,14,11,19,44,50,68,9,10,25,44,35,68
Oberneuland,0,0,2,2,1,14,0,0,0,0,0,0
Guam,5,1,4,10,17,17,1,2,9,12,5,28
Marino,0,0,1,1,0,1,0,1,1,2,1,2
Francavilla,0,0,0,0,0,0,0,0,1,1,0,2
S Dniprodzerzhynsk (do not use,8,7,4,19,27,24,4,5,9,18,19,26
Slovenia,15,9,6,30,42,20,7,7,20,34,30,40
Little Oakley,0,1,0,1,2,2,0,0,0,0,0,0
Linfield,94,28,26,148,329,134,92,24,39,155,286,169
Barry Town,32,12,17,61,108,77,25,9,29,63,63,98
Arenas Club,0,0,1,1,1,2,0,0,1,1,0,2
Hajvalia,0,0,1,1,0,3,0,0,0,0,0,0
Ellistown & Ibstock United,1,0,0,1,2,1,0,0,1,1,1,2
Portugalete,2,0,2,4,3,5,0,0,1,1,1,2
Valladolid,65,53,42,160,211,167,48,47,74,169,191,234
Paksi SE,56,34,30,120,192,134,30,35,56,121,150,196
Sheff Wed,83,55,53,191,261,195,61,54,84,199,218,276
Adelaide Utd,50,27,25,102,170,128,37,19,46,102,139,158
Sonnenhof G,1,1,0,2,5,2,0,1,2,3,1,7
El Alamo,1,0,1,2,2,2,0,0,0,0,0,0
Sete,4,0,2,6,8,3,1,1,2,4,6,7
Dagenh'm,0,1,0,1,1,1,0,0,0,0,0,0
Erith & Belv,1,1,1,3,3,4,4,1,3,8,16,17
Mongolia,3,0,5,8,6,21,1,1,9,11,15,29
Deportiva Ceuta,0,0,1,1,0,3,0,0,0,0,0,0
Institute FC,11,11,31,53,52,105,8,14,36,58,63,134
Kallithea,0,0,1,1,2,3,0,0,0,0,0,0
Maldives,2,0,7,9,8,20,3,1,6,10,10,26
Lech Poznan,87,34,34,155,275,139,51,43,58,152,198,184
Thurnby Nir,4,0,3,7,17,12,5,1,5,11,23,22
Guernsey,1,0,0,1,4,0,0,1,3,4,3,8
Erzegbirge A,43,26,28,97,129,121,21,24,52,97,96,151
Czech Rep,16,7,11,34,57,37,18,3,17,38,57,57
Dereham Town,2,0,5,7,7,14,1,1,2,4,6,11
Chievo,37,39,43,119,131,147,25,22,65,112,87,184
Colegios Diocesanos,0,0,0,0,0,0,0,0,1,1,0,3
Union Berlin,53,34,18,105,184,106,34,30,51,115,152,190
Seaham Red Star,1,0,3,4,6,11,5,1,3,9,15,11
Neftchi Baku,8,5,11,24,36,39,7,7,11,25,24,36
Germany U21,13,4,1,18,39,13,4,3,4,11,16,16
Ath Bilbao II,1,0,0,1,1,0,0,0,0,0,0,0
Reading U21,3,3,2,8,16,17,5,1,3,9,21,21
SV Elversberg,3,1,3,7,14,14,1,4,0,5,10,6
FC Utd,69,36,48,153,284,230,54,34,59,147,211,233
AE Paphos,1,0,0,1,1,0,0,0,4,4,3,21
Daring Echternach,0,0,1,1,1,6,0,0,0,0,0,0
Gretna,0,0,0,0,0,0,0,0,1,1,1,2
Aston,0,0,0,0,0,0,0,0,1,1,0,4
Pulpileno,0,0,1,1,1,2,0,0,0,0,0,0
Tre Fiori,0,1,7,8,0,18,0,1,7,8,4,25
Uttoxeter Town,3,0,2,5,16,13,1,2,1,4,3,4
Bologna,47,32,55,134,178,179,29,32,69,130,120,206
Roman Glass St George,0,0,2,2,1,4,2,0,1,3,8,8
Northwich Manchester Villa,0,1,0,1,1,1,0,0,1,1,1,3
Dundonald Bluebell,0,1,2,3,5,10,0,0,1,1,1,6
Leher TS,0,0,1,1,0,5,0,0,0,0,0,0
Cruz Azul,5,1,1,7,20,6,2,2,1,5,7,5
Bnei Yehuda,36,33,49,118,123,143,41,37,41,119,137,132
Iraq,17,10,8,35,51,34,9,12,9,30,33,33
Nuremberg,41,32,44,117,160,171,39,30,53,122,174,201
Gosk Gabela,0,0,2,2,0,3,0,0,1,1,1,3
Virtus Francavilla,2,0,0,2,5,2,0,0,4,4,1,13
Chambly,5,4,6,15,22,21,10,4,6,20,25,19
Cailungo,0,0,0,0,0,0,0,0,1,1,1,3
Tahiti,4,2,2,8,13,7,2,1,1,4,35,4
Portsm'th U23,0,0,0,0,0,0,0,1,0,1,0,0
Tambov,8,3,19,30,31,42,4,5,22,31,24,62
Troon Juniors,0,0,0,0,0,0,0,1,1,2,3,4
Pap New Guinea,3,2,4,9,17,11,3,0,6,9,12,22
Celta Vigo,69,48,44,161,247,205,49,41,78,168,205,272
Stowmarket,7,0,0,7,26,2,1,1,2,4,1,3
Bacup Borough,0,0,0,0,0,0,0,0,1,1,0,1
Chamalieres,0,0,0,0,0,0,0,1,0,1,0,0
The New Saints,98,23,16,137,359,109,83,28,27,138,341,137
Vodojaza,0,0,1,1,0,6,0,0,0,0,0,0
E Stirling,39,15,52,106,169,191,46,16,43,105,181,172
Clachnacuddin,18,6,33,57,87,128,7,13,34,54,63,132
Lens II,0,1,0,1,1,1,0,0,0,0,0,0
Arlesey,7,9,20,36,39,65,10,3,24,37,43,86
Sandbach United,0,0,0,0,0,0,0,0,2,2,2,5
Red Star Brno,0,0,1,1,2,3,0,0,0,0,0,0
New Zealand Women,0,0,1,1,0,1,4,0,5,9,7,13
M. Haifa,71,30,40,141,233,150,53,37,50,140,169,162
Rusthall,0,0,2,2,2,9,0,0,1,1,1,2
Santos Laguna,3,0,0,3,12,4,2,0,1,3,8,5
Wolves U23,3,1,1,5,13,7,2,1,4,7,10,12
Potenza,1,0,1,2,2,2,0,0,2,2,0,18
Sporting Khalsa,8,2,2,12,29,17,5,1,5,11,20,20
Galway,0,0,2,2,1,4,1,0,2,3,4,5
Niort,5,4,7,16,23,27,5,4,17,26,26,46
Bridgwater T,2,2,2,6,12,9,4,2,4,10,22,21
Tynecastle BC,0,1,0,1,0,0,0,0,1,1,0,8
Croatia Women,0,0,0,0,0,0,0,1,1,2,2,3
Kirklarelispor,0,1,0,1,0,0,0,0,1,1,0,3
Brighton U21,6,5,2,13,27,13,8,6,7,21,35,29
London Colney,4,1,2,7,16,12,1,0,3,4,6,7
Augsburg,44,36,55,135,196,210,43,29,68,140,157,218
Tividale,0,0,0,0,0,0,0,0,2,2,1,5
Besa Peje,0,0,1,1,1,2,0,0,0,0,0,0
Zemun,11,13,13,37,39,35,6,9,22,37,36,64
C Zeiss Jena,4,0,6,10,15,19,1,2,3,6,3,7
Arcos,0,0,0,0,0,0,0,0,1,1,0,2
CSKA Mosc.,79,31,31,141,246,113,67,30,44,141,200,157
Raynes Park Vale,1,1,2,4,4,9,1,0,1,2,3,5
Union Mertert,0,0,1,1,0,2,0,0,0,0,0,0
FC Inter,48,30,32,110,164,118,30,29,52,111,128,163
Ioannina,38,34,31,103,113,95,24,28,51,103,96,145
Bahamas,0,0,2,2,0,9,0,0,2,2,0,7
DR Congo,12,8,9,29,43,30,12,16,12,40,56,49
Dacia,5,2,8,15,25,22,6,3,4,13,19,19
Werder Bremen II,2,0,0,2,7,0,1,0,2,3,4,12
Z Bydgoszcz,8,5,13,26,26,37,8,5,17,30,38,58
Sandvikens,0,1,1,2,3,5,0,0,1,1,1,3
Seyssinet-Pariset,0,0,1,1,0,4,0,0,0,0,0,0
FC Ulisses,1,1,4,6,5,14,0,1,1,2,1,3
Hibernian,93,51,40,184,347,218,77,39,52,168,239,179
Anorthosis Fam.,3,5,5,13,16,16,4,3,12,19,20,40
Los Angeles FC,33,15,6,54,130,63,17,11,21,49,90,85
Blois,0,0,1,1,1,2,0,0,1,1,0,2
Babte,0,0,1,1,0,5,0,0,1,1,0,1
Newcastle Jets,32,28,41,101,131,146,27,18,53,98,118,173
Uni Cluj,9,7,9,25,19,27,6,8,12,26,24,31
Colombia,19,14,7,40,56,30,21,9,10,40,63,41
CP Merida,0,0,0,0,0,0,0,1,0,1,1,1
Scotland Women,2,1,0,3,7,5,1,1,2,4,4,5
Rodeo,0,0,1,1,0,1,0,1,0,1,2,2
Woodbridge T,1,1,2,4,6,7,3,0,2,5,13,7
Radcliffe Boro,10,6,12,28,34,46,6,0,20,26,26,62
Ware,2,0,1,3,5,2,2,1,6,9,10,20
Orsha,0,0,1,1,1,4,0,0,0,0,0,0
Schwaz,0,0,1,1,0,6,0,0,0,0,0,0
Sheff Utd,102,34,55,191,288,183,70,53,67,190,244,253
Atletico Porcuna,0,0,0,0,0,0,0,0,1,1,0,2
USA Women,9,1,0,10,43,5,4,0,0,4,8,3
Alnwick Town,0,0,1,1,4,6,0,0,0,0,0,0
Palanga,0,0,1,1,0,2,0,0,1,1,0,2
V de S Brigida,0,0,0,0,0,0,0,0,1,1,2,4
Titograd Podgorica,0,1,2,3,1,3,1,1,1,3,2,5
Dnipro,32,14,17,63,96,54,28,19,16,63,89,61
Smorgon,1,0,3,4,3,7,0,1,5,6,1,15
Havant & W,89,34,47,170,299,191,62,43,52,157,216,208
Jelgava,10,5,3,18,30,15,6,6,9,21,21,29
PK-35,2,5,9,16,16,27,2,2,13,17,16,38
London Tigers,0,0,0,0,0,0,0,0,1,1,3,9
Bangor City,41,6,29,76,127,116,25,17,31,73,97,127
Tarbes,0,0,0,0,0,0,0,1,0,1,0,0
Johvi FC Lokomotiv,0,0,2,2,2,8,0,0,1,1,1,6
Burntisland S,0,1,1,2,2,5,0,0,1,1,0,14
UCC,0,0,0,0,0,0,0,0,1,1,1,4
Fulham U21,5,2,5,12,19,17,3,5,16,24,38,59
Kecskemeti,10,6,5,21,25,17,4,5,13,22,17,42
Makedonia,0,0,2,2,3,6,0,0,0,0,0,0
UE Santa,2,0,7,9,8,18,2,3,5,10,8,17
Dundee U20,0,1,2,3,5,8,0,1,2,3,4,7
SV Rodinghausen,1,2,1,4,8,8,0,0,0,0,0,0
Aiglon du Lamentin,0,0,0,0,0,0,0,0,1,1,2,3
Cockhill C,0,0,0,0,0,0,0,0,3,3,1,5
FC Giessen,0,0,1,1,0,2,0,0,0,0,0,0
FeralpiSalo,5,1,1,7,14,5,2,0,6,8,5,13
Blackburn U23,3,2,0,5,9,4,1,0,4,5,2,6
Oxhey Jets,2,0,0,2,11,1,0,0,4,4,1,12
Burgess Hill,36,21,49,106,150,191,17,28,53,98,106,191
Banga,0,3,1,4,2,3,1,1,4,6,1,9
Torino,75,46,43,164,272,190,42,52,63,157,209,246
Norway U21,1,0,1,2,1,6,0,1,3,4,4,9
Wrexham,90,51,44,185,263,157,53,52,77,182,196,249
At Sanluqueno,1,0,0,1,1,0,0,0,1,1,0,1
Zanzibar,0,0,0,0,0,0,1,0,0,1,2,1
Kyzyl-Zhar,0,0,1,1,1,3,0,0,1,1,0,3
Covilha,0,1,1,2,1,2,1,0,0,1,2,1
Tottenham U21,3,3,8,14,23,30,3,5,13,21,30,46
Thamesmead T,9,4,3,16,30,18,6,2,9,17,23,26
Hastings Utd,1,3,5,9,13,20,7,0,4,11,20,14
Din. Bucharest,67,33,37,137,202,145,48,35,57,140,171,189
Nigeria Olympic,2,0,1,3,7,6,2,0,1,3,4,4
Cliftonville,90,24,35,149,295,157,55,32,54,141,205,206
Hyde,34,26,48,108,170,186,24,22,65,111,123,213
Genclerbirligi,43,34,36,113,138,120,26,21,68,115,121,209
Paris,7,8,7,22,18,23,3,4,7,14,9,25
Diosgyor,57,25,40,122,181,164,25,28,72,125,118,220
Ashton Town,0,0,1,1,0,4,0,0,1,1,1,2
March Town Utd,0,0,1,1,0,1,0,0,0,0,0,0
Market Drayton,0,2,1,3,4,5,1,0,5,6,6,15
GNP Sports,0,0,1,1,2,6,0,0,0,0,0,0
Aarhus,46,24,40,110,160,146,34,34,43,111,146,159
Manchester United Gibraltar,0,0,1,1,0,4,0,1,1,2,1,8
Lewes,32,33,44,109,131,155,27,27,55,109,129,191
Nesebar,0,0,1,1,1,3,0,0,0,0,0,0
Muret,0,0,1,1,0,2,0,0,0,0,0,0
Wigan,79,57,57,193,261,206,62,41,90,193,252,278
Whitchurch United,0,1,0,1,2,2,0,0,2,2,1,6
Queen's Park,58,43,56,157,202,198,55,41,59,155,198,201
OFK Belgrade,19,6,14,39,48,46,5,8,29,42,38,73
Colville Park,1,0,0,1,2,1,0,0,1,1,0,9
Grimsby Borough,2,0,0,2,5,0,1,0,2,3,4,7
La Louviere,0,0,0,0,0,0,0,0,1,1,1,2
Guinea,8,6,4,18,30,19,9,7,14,30,34,46
Hemel,63,43,50,156,232,221,56,40,57,153,251,250
Blackfield & L,8,7,8,23,29,27,7,4,14,25,26,53
Canning Town,0,0,1,1,5,7,0,0,0,0,0,0
Benfica,133,27,20,180,446,131,108,32,36,176,322,165
Braintree,67,35,66,168,209,211,53,31,78,162,208,253
Sao Tome & P,2,0,4,6,3,9,0,0,6,6,1,15
Westbury Utd,0,0,1,1,0,1,0,1,1,2,3,4
Shkupi,1,1,3,5,4,8,0,1,6,7,5,16
Bedlington Ter.,2,0,2,4,7,8,0,0,1,1,1,3
Dag Liepaja,7,1,7,15,17,17,6,3,9,18,16,27
Ivory Coast,19,11,6,36,59,31,16,13,13,42,48,44
At Baleares,0,2,1,3,1,2,0,2,2,4,3,5
Petersfield Town,0,0,4,4,3,11,1,1,1,3,3,5
Blyth Sptns,84,26,48,158,311,211,68,31,58,157,265,253
Melilla CD,1,0,1,2,2,5,0,0,0,0,0,0
Bulgaria U21,0,0,1,1,0,3,0,0,1,1,0,1
Cirencester,26,15,34,75,120,134,27,15,33,75,96,116
Lucan United,0,0,0,0,0,0,0,0,1,1,1,3
Pinxton,2,0,1,3,7,5,1,0,2,3,7,14
FC Zurich,44,40,43,127,183,177,42,32,58,132,173,227
Alverca,1,0,0,1,2,0,0,0,0,0,0,0
Sunderland,67,60,57,184,253,220,57,51,74,182,219,259
St Montois,0,0,1,1,0,2,1,0,1,2,2,4
Codicote,0,0,1,1,1,7,0,0,0,0,0,0
Cerceda,0,0,0,0,0,0,0,0,1,1,0,1
Viterbese,1,0,1,2,1,2,1,1,1,3,5,2
Hatayspor,10,4,5,19,35,22,7,5,8,20,26,31
Lesmahagow Jnrs,0,0,0,0,0,0,0,0,2,2,2,15
Villarrubia,0,0,0,0,0,0,0,1,0,1,0,0
Club Rapido de Bouzas,1,0,2,3,5,7,0,0,1,1,0,2
Lymington T,1,0,1,2,3,2,0,0,3,3,1,5
Mauritius,2,3,5,10,9,14,1,5,10,16,12,37
Saint-Amand,0,1,0,1,1,1,0,0,0,0,0,0
Boluspor,0,0,1,1,0,1,0,0,1,1,1,4
Santa Clara,16,14,19,49,63,63,16,12,25,53,55,64
Sutton Cold.,32,14,32,78,113,124,11,14,47,72,59,151
South Korea Women,1,1,2,4,6,6,1,0,3,4,5,7
Tunbridge Wells,1,1,2,4,7,9,2,2,2,6,11,12
Guiseley,62,40,59,161,237,221,43,50,74,167,190,264
Barcelona,171,27,18,216,653,177,131,46,40,217,442,206
Dinaz Vyshhorod,0,1,0,1,0,0,0,0,0,0,0,0
Costuleni,0,0,1,1,0,1,0,0,1,1,0,1
Jaen,5,5,4,14,17,14,2,8,5,15,10,14
SonderjyskE,52,36,38,126,169,139,37,36,57,130,168,213
Vitesse Arn.,69,38,31,138,264,160,47,32,57,136,202,197
AFC Stoneham,0,0,1,1,1,3,0,0,1,1,1,2
Zaragoza,75,43,51,169,215,173,46,56,65,167,196,228
Epsom & Ewell,1,0,1,2,3,3,1,0,3,4,11,14
Surinam,1,0,2,3,6,7,1,0,3,4,7,4
AFC Emley,1,0,2,3,6,9,0,0,1,1,2,4
La Roda,0,0,0,0,0,0,0,0,1,1,1,4
Kilwinning Rang,0,1,0,1,0,0,0,0,1,1,1,3
Tring Athletic,4,1,2,7,14,8,5,2,3,10,21,10
Norwich United,2,0,3,5,10,8,2,0,4,6,11,12
Malvern Town,2,2,1,5,18,15,2,0,2,4,7,13
Thatcham Town,9,0,3,12,32,17,10,0,2,12,33,14
Timor-Leste,2,1,4,7,7,19,1,1,4,6,3,30
Ingolstadt II,0,0,1,1,1,2,1,0,0,1,3,0
Kizilcabolukspor,0,0,1,1,0,4,0,0,0,0,0,0
Ch'morets N.,0,0,1,1,0,1,0,0,0,0,0,0
Luckenwalde,0,0,0,0,0,0,0,0,1,1,0,4
MTV Eintracht Celle,0,0,1,1,0,7,0,0,0,0,0,0
Anstey Nomads,3,0,0,3,6,2,1,1,1,3,2,2
China,22,15,13,50,82,50,8,6,9,23,34,24
Osijek,79,35,25,139,221,108,41,36,63,140,154,193
Prishtina,2,3,2,7,6,5,3,2,3,8,7,11
Belfort,3,2,2,7,8,7,2,0,3,5,5,7
Racing Rioja,1,0,1,2,3,2,0,0,0,0,0,0
FK Araz,1,0,0,1,3,0,0,0,1,1,0,4
Astra Giurgiu,69,43,39,151,234,167,56,44,52,152,178,175
AFC St Austell,5,0,2,7,21,7,6,0,2,8,25,22
Thaon,1,0,0,1,4,1,0,0,0,0,0,0
Qabala,23,11,10,44,80,44,9,8,22,39,33,58
Rumilly Vallieres,3,2,0,5,12,2,0,3,1,4,3,4
Peralada,0,0,0,0,0,0,0,0,1,1,0,1
North Shields,8,1,1,10,27,10,6,1,3,10,18,13
Congo,6,8,8,22,23,29,5,6,10,21,20,29
Liverpool U21,5,1,2,8,19,8,4,2,6,12,19,26
Caen,37,21,49,107,119,152,32,30,56,118,130,184
Vale of Leithen,11,7,28,46,70,134,7,6,43,56,51,203
Knaresborough Town,0,0,1,1,2,4,0,1,1,2,3,4
Rusadir,0,0,1,1,1,2,0,0,0,0,0,0
Tavistock,3,0,2,5,18,8,5,0,3,8,17,10
Atlanta U,47,12,15,74,157,69,24,16,32,72,92,108
Unterhaching,4,5,4,13,20,20,4,1,5,10,15,13
Le Portel,0,0,1,1,1,4,0,0,0,0,0,0
Colney Heath,1,1,3,5,5,8,3,2,2,7,14,12
Quintanar del Rey,0,0,1,1,1,2,0,0,0,0,0,0
Gelbison,0,0,0,0,0,0,0,0,1,1,1,3
ES Setif,0,1,1,2,2,3,0,0,0,0,0,0
Lydney Town,0,0,0,0,0,0,0,0,1,1,1,3
Telford,62,32,59,153,228,227,46,40,74,160,202,250
Shelbourne,48,28,27,103,170,109,47,20,38,105,141,128
Nepal,0,2,1,3,0,1,1,0,5,6,3,21
Zlate Moravce,1,1,6,8,8,19,0,0,10,10,6,27
Whitehawk,45,33,56,134,187,203,46,22,59,127,183,225
Raon L Etape,0,1,2,3,4,6,0,0,1,1,0,2
Millbrook,2,0,0,2,5,1,0,0,1,1,2,3
Larkhall,3,1,4,8,16,14,2,2,4,8,7,13
IK Start,23,19,34,76,102,132,9,17,51,77,72,168
Reggiana,2,2,0,4,7,3,2,0,5,7,8,17
Pavia,2,2,0,4,8,3,2,2,2,6,7,5
Litex,21,8,7,36,58,22,10,14,12,36,46,51
Yorkshire Amateur,1,0,0,1,5,4,1,1,1,3,4,3
Albania,13,5,17,35,36,49,14,6,12,32,40,29
Cen Af Rep,0,0,1,1,0,3,1,2,0,3,6,5
Esbjerg,30,35,30,95,125,130,23,22,49,94,95,156
Feurs,0,1,0,1,0,0,0,0,0,0,0,0
Palestine,9,4,3,16,46,16,7,7,13,27,27,38
Sp Bengal Utd,1,0,2,3,7,10,0,0,0,0,0,0
Haguenau,1,1,0,2,3,2,0,0,0,0,0,0
Clitheroe,4,0,4,8,12,17,1,0,3,4,2,6
Uni Craiova,68,34,30,132,184,113,51,32,51,134,155,156
Hessen Dreieich,0,1,0,1,2,2,0,0,0,0,0,0
Karpaty Lvov,25,24,44,93,103,137,18,36,38,92,89,130
Leicester U21,8,2,2,12,26,8,13,9,9,31,48,45
Kalloni,18,11,11,40,49,39,2,9,29,40,18,82
Besancon,0,0,2,2,1,6,0,0,0,0,0,0
Petange,1,0,1,2,2,3,0,0,2,2,1,7
TB Tvoroyri,0,1,3,4,1,5,0,1,2,3,0,4
Mexico Women,0,0,1,1,1,2,0,0,3,3,0,8
Akhisar Spor Kulubu,0,0,1,1,0,1,0,0,0,0,0,0
Sumqayit,4,3,3,10,12,14,1,0,15,16,7,34
Kolkheti Poti,0,1,2,3,3,7,0,2,2,4,1,5
Zaria Balti,4,1,2,7,12,6,0,1,11,12,4,39
Academia UTM,0,0,1,1,1,3,0,0,0,0,0,0
Metta Riga,0,2,4,6,2,13,0,0,9,9,3,20
Otelul Galati,8,5,10,23,24,21,6,8,11,25,22,39
Seraing,0,1,0,1,1,1,1,0,0,1,5,2
Loughbr'gh Dy,3,0,4,7,14,17,0,1,4,5,2,13
Kaposvar,5,4,14,23,21,44,1,2,20,23,12,53
Belper Town,7,9,14,30,52,57,1,8,18,27,27,59
Hucknall,2,0,1,3,9,5,1,0,3,4,8,11
Maximoise,0,0,1,1,1,3,0,0,0,0,0,0
Vorskla Poltava,48,31,33,112,141,122,36,29,51,116,113,151
Rukh Vynnyky,4,5,4,13,16,16,2,5,6,13,11,23
Bastia,36,25,21,82,106,83,16,15,45,76,58,131
S Walden T,4,0,2,6,20,14,1,1,2,4,9,10
KSV Baunatal,0,0,1,1,2,3,0,0,0,0,0,0
Adriese,0,0,1,1,0,1,0,0,0,0,0,0
AlmerÃ­a II,0,0,1,1,0,2,0,0,2,2,0,2
Lokeren,38,32,35,105,136,130,26,32,50,108,132,170
Northampton Sileby Rangers,2,1,0,3,12,6,0,0,2,2,2,9
B Leverkusen,85,40,42,167,319,213,80,32,61,173,296,225
Albissola,0,0,1,1,0,1,0,0,0,0,0,0
Saudi Arabia,26,10,12,48,80,47,9,7,15,31,50,50
Lothian Thistle,6,1,3,10,18,17,2,2,2,6,10,12
Bristol C U23,1,0,0,1,3,1,1,0,0,1,2,1
