,wins,draws,losses,played,scored,conceived
RSV Meinerzhagen,0,0,1,1,1.0,6.0
Zalaegerszeg,21,16,27,64,1.640625,1.515625
Hull U21,2,0,1,3,1.333333,1.0
Oakham Utd,0,0,1,1,1.0,8.0
AFC Kempston R,3,2,6,11,1.272727,1.636364
Europa Point,0,0,2,2,0.0,9.0
Alcorcon,90,92,103,285,0.933333,1.045614
Denmark Women,2,1,6,9,1.333333,1.666667
Plabennec,0,0,2,2,1.0,4.0
Colorado,57,46,79,182,1.192308,1.5
FC Liege,1,0,0,1,3.0,0.0
B. Banja Luka,2,0,3,5,0.8,1.6
Gremio,1,0,1,2,0.5,0.5
VCD Athletic,19,16,41,76,1.131579,1.947368
Al-Hilal,3,1,1,5,2.2,1.4
Finland,24,12,27,63,1.047619,1.15873
Port Vale,113,87,135,335,1.152239,1.319403
Venezia,3,4,2,9,1.333333,1.111111
Dnipro,39,26,23,88,1.431818,0.943182
Randers Freja,78,56,85,219,1.260274,1.273973
Kelty Hearts,54,12,14,80,2.6875,0.9125
Sunderland,108,96,112,316,1.306962,1.294304
Go A Eagles,9,8,38,55,0.763636,1.927273
Paksi SE,73,59,77,209,1.363636,1.401914
Lymington T,1,0,4,5,0.8,1.4
Lege-Cap-Ferret,0,1,1,2,1.5,2.0
Sp Subotica,90,48,93,231,1.307359,1.350649
Pirin,24,29,47,100,0.99,1.35
Colombia Women,1,1,0,2,1.5,0.5
Liversedge,2,1,2,5,2.4,1.8
Adelaide Utd,73,38,61,172,1.511628,1.459302
FC Brasov,3,6,8,17,0.764706,1.117647
Kennington,2,2,1,5,1.8,2.0
Conquense,0,0,2,2,0.0,1.5
FC Copenhagen,171,61,65,297,1.79798,0.969697
Versailles,0,0,1,1,1.0,2.0
Differdange 03,17,3,10,30,2.033333,1.4
Nantes,88,63,110,261,1.10728,1.283525
Northampton Sileby Rangers,2,1,2,5,2.8,3.0
Garching,0,0,1,1,0.0,3.0
Nepal,1,2,6,9,0.333333,2.444444
Blackburn Utd,0,0,4,4,1.5,3.25
Leiston,76,45,60,181,1.751381,1.353591
Herediano,1,1,2,4,1.5,2.5
SSEP Hombourg-Haut,0,1,1,2,0.5,2.0
Helios,0,0,1,1,0.0,13.0
Surinam,2,0,5,7,1.857143,1.571429
Stockport Town,2,0,3,5,2.2,2.2
Tadley Calleva,2,1,2,5,2.2,3.0
Shortwood Utd,2,1,3,6,1.5,1.666667
Marske Utd,17,1,7,25,2.32,1.56
Raith,126,65,86,277,1.574007,1.3213
Leighton,14,0,5,19,2.473684,1.894737
Lietava,1,0,0,1,1.0,0.0
Pistoiese,0,0,1,1,0.0,1.0
SC Hazebrouck,0,0,1,1,0.0,2.0
Ulm,0,1,1,2,1.5,2.0
Cambridge C,36,22,62,120,1.266667,1.658333
Buxton,102,66,87,255,1.627451,1.4
Sestao,1,1,3,5,1.0,2.0
Rangers U20,7,1,4,12,1.833333,1.25
FC Naftan,20,20,47,87,0.91954,1.597701
Bulgaria U21,0,0,2,2,0.0,2.0
OB Odense,76,54,88,218,1.279817,1.330275
Ulsan Hyundai,0,0,2,2,1.0,2.5
Barcelona B,16,18,35,69,1.173913,1.550725
Cruz Azul,3,1,1,5,3.0,0.6
Vik Cologne,0,0,1,1,2.0,4.0
Francavilla,0,0,1,1,0.0,2.0
Dundee,83,64,119,266,1.218045,1.533835
Wolves,142,81,96,319,1.369906,1.106583
Witton,64,40,57,161,1.447205,1.341615
St Panteleimon,0,0,1,1,1.0,3.0
Pena Azagresa,1,0,1,2,0.5,1.0
Olympic,0,0,1,1,0.0,16.0
Fortuna Cologne,1,1,2,4,0.75,1.5
B68 Toftir,0,0,1,1,1.0,3.0
FC Zurich,64,62,87,213,1.305164,1.596244
Westfield,5,2,4,11,1.818182,1.363636
Basel,170,61,63,294,2.027211,1.163265
Sutton Athletic,0,0,1,1,0.0,2.0
Malta,7,12,38,57,0.614035,2.017544
Germany,42,17,15,74,2.202703,1.054054
Chad,2,1,3,6,0.666667,1.5
AC Bobigny,1,0,2,3,0.666667,1.333333
Hermannstadt,28,35,48,111,0.972973,1.351351
Juvenes,1,1,4,6,0.666667,3.0
Lovcen,0,1,4,5,0.4,2.6
NK Rudes,13,15,44,72,0.930556,1.972222
NK Karlovac,0,0,1,1,0.0,7.0
Peterhead,120,51,94,265,1.588679,1.339623
Bedfont Sports,3,4,5,12,1.333333,2.166667
Dinamo Brest,96,46,58,200,1.645,1.14
Airbus UK,29,20,59,108,1.361111,2.101852
Litherland R,0,0,3,3,1.0,3.666667
Garliava,0,0,1,1,0.0,8.0
Iceland U21,0,0,4,4,0.75,3.75
US Ste Marie,0,0,1,1,0.0,2.0
S'derland R CW,5,1,3,9,2.555556,1.444444
Eastleigh,120,87,104,311,1.369775,1.334405
Haiti,19,5,19,43,1.581395,1.488372
AC Horsens,41,49,71,161,1.043478,1.658385
Huddersfield,86,73,145,304,1.046053,1.539474
Lauda,0,0,1,1,0.0,7.0
Malta U21,0,0,1,1,0.0,4.0
Guangzhou Ev,2,0,2,4,1.5,1.5
Montelimar,0,0,1,1,1.0,2.0
Maribor,146,75,46,267,1.868914,0.996255
Lausanne,31,25,51,107,1.392523,1.654206
Aberdeen U20,2,0,6,8,1.5,2.875
Vaprus,0,0,2,2,0.5,10.5
Thornaby,2,1,1,4,5.0,3.5
Bergerac,0,1,0,1,1.0,1.0
London Lions,1,0,1,2,1.5,1.5
Crewe,110,72,143,325,1.301538,1.526154
Bishop Sutton,0,0,1,1,0.0,3.0
Bishop's Cleeve,3,0,6,9,1.555556,2.111111
Qatar,36,12,24,72,1.708333,1.055556
Herne Bay,6,4,5,15,1.333333,1.8
Dominica,2,1,6,9,0.666667,2.333333
Whitehawk,72,48,96,216,1.407407,1.680556
Dalkurd FF,7,6,20,33,1.060606,2.0
F Dusseldorf,79,52,84,215,1.344186,1.52093
Carshalton,56,22,30,108,1.75,1.268519
Sholing,12,2,7,21,1.714286,1.380952
Somozas,1,0,0,1,1.0,0.0
Highgate United,3,1,3,7,2.0,2.0
Rudar Pljevlja,4,4,6,14,0.928571,1.142857
Llosetense,0,0,1,1,0.0,3.0
Llanera,0,0,1,1,0.0,5.0
Tosno,6,6,18,30,0.766667,1.8
Jeunesse Evolution,0,0,1,1,0.0,2.0
Annan,105,50,105,260,1.592308,1.542308
Stone Old Alleynians,1,0,1,2,2.5,2.5
Corby,39,23,57,119,1.336134,1.739496
Dinamo Vranje,9,6,24,39,0.615385,1.897436
FC Inter,69,47,70,186,1.327957,1.241935
Saltash Utd,3,0,3,6,2.166667,2.5
Dilj,0,0,1,1,0.0,6.0
Partizan,177,55,51,283,1.939929,0.862191
Belshina,27,23,42,92,1.347826,1.576087
East Fife,103,52,102,257,1.389105,1.385214
Cincinnati,10,12,38,60,0.766667,1.983333
Kidsgrove Ath,11,4,6,21,1.857143,1.333333
Ayia Napa,0,0,1,1,0.0,1.0
Lucon,0,0,1,1,0.0,1.0
Varese,0,0,1,1,1.0,3.0
Livorno,2,5,10,17,0.941176,1.823529
Getafe,99,74,107,280,1.103571,1.185714
Baltika,0,1,1,2,1.5,2.0
Myanmar,6,2,15,23,0.869565,2.521739
Colombia Olympic,1,2,1,4,1.5,1.5
Stjarnan,10,4,17,31,1.193548,1.709677
Inverness CT,117,80,89,286,1.454545,1.258741
Limoges,0,0,3,3,1.0,5.0
Reading City,0,0,1,1,0.0,1.0
Altach,77,53,101,231,1.225108,1.450216
Rothes,48,16,43,107,2.056075,1.878505
Nigeria Olympic,4,0,2,6,1.833333,1.666667
Walsham Le Willows,1,0,2,3,2.0,1.333333
Peru,28,17,26,71,1.267606,1.140845
Highworth,5,5,8,18,1.388889,1.888889
Lyon,164,70,83,317,1.914826,1.198738
Jedinstvo (Ser),0,0,1,1,0.0,3.0
Felixstowe & W,5,0,6,11,1.545455,2.0
Stafford Town,0,0,1,1,0.0,1.0
Kaiserslautern II,0,0,1,1,0.0,1.0
Newbury Forest,0,0,2,2,1.0,3.5
Aktobe,0,5,10,15,0.6,1.866667
Bangladesh,1,3,11,15,0.333333,3.0
Gandzasar,5,5,8,18,1.111111,1.611111
Coventry United,10,3,3,16,2.625,1.1875
Braunschweig,49,43,52,144,1.194444,1.291667
Kauno Zalgiris,2,1,6,9,0.888889,2.444444
Baffins Milton R,5,0,3,8,2.0,1.875
Chasselay MDA,0,1,0,1,1.0,1.0
Genclerbirligi,57,46,90,193,1.103627,1.445596
Burgess Hill,48,48,101,197,1.253807,1.913706
Din. Moscow,51,55,60,166,1.036145,1.126506
Slovan Liberec,105,53,79,237,1.333333,1.14346
Lewes,46,42,80,168,1.172619,1.577381
Javor,48,47,79,174,1.005747,1.413793
Morpeth Town,26,13,15,54,1.907407,1.518519
Willand Rovers,7,0,5,12,2.25,1.916667
Needham M,54,37,64,155,1.432258,1.722581
Monterrey,8,3,2,13,2.153846,0.846154
Gzira United,1,2,9,12,0.666667,2.083333
Furiani-Agliani,0,1,1,2,1.0,1.5
Concord R,89,68,98,255,1.396078,1.454902
Hostert,1,0,5,6,1.5,3.833333
N'thampton On C,0,0,3,3,1.666667,3.666667
Macedonia U21,5,2,4,11,1.272727,1.363636
Denmark U21,14,4,10,28,1.535714,1.5
Bowers & Pitsea,23,13,21,57,1.877193,1.438596
Winchester City,4,2,5,11,2.090909,1.909091
Foggia,4,2,7,13,1.461538,1.846154
Budafoki MTE,0,0,2,2,1.5,3.0
Loko. Plovdiv,88,51,79,218,1.279817,1.233945
Birkirkara,15,7,6,28,1.571429,0.892857
Boldmere St. M,2,0,4,6,1.333333,2.166667
Wiedenbruck,0,1,1,2,0.0,2.5
LKS Nieciecza,32,28,51,111,1.018018,1.540541
Wurz. Kickers,15,23,39,77,1.025974,1.649351
Titograd Podgorica,1,2,3,6,0.5,1.333333
FK Indija,17,8,38,63,0.825397,1.571429
Inter Baku,8,8,10,26,1.153846,1.346154
Concordia C,44,48,85,177,1.011299,1.412429
Bradford Town,13,1,7,21,2.428571,1.809524
Dunston UTS,10,2,8,20,1.7,1.55
Ballymena,96,39,106,241,1.589212,1.709544
Chelmsley T,0,0,2,2,1.5,3.5
Melfi,0,0,1,1,0.0,2.0
Merida AD,0,3,3,6,1.0,2.333333
Barnton,1,0,1,2,0.5,2.0
Zlate Moravce,1,1,11,13,0.846154,2.615385
Panaitolikos,0,0,1,1,0.0,3.0
Cordoba,70,46,98,214,1.196262,1.509346
Aston Villa,111,67,125,303,1.30033,1.372937
Frejus Saint-Raphael,9,4,5,18,1.555556,0.944444
Anguilla,0,0,5,5,0.0,4.2
Rangers,209,70,59,338,2.08284,0.890533
FC Sheriff,55,20,14,89,2.269663,0.662921
FC Aarau,4,5,10,19,1.0,2.0
IF BP,9,4,22,35,0.857143,2.028571
Marchamalo,0,1,1,2,1.0,1.5
Potenza,1,0,3,4,0.5,5.0
Sanremo,0,0,2,2,0.0,1.0
Stocksbridge,8,3,6,17,1.882353,2.117647
Hapoel Acre,23,15,47,85,0.8,1.6
Orebro,61,46,78,185,1.297297,1.632432
Grasshoppers,48,44,77,169,1.325444,1.64497
GNP Sports,0,0,1,1,2.0,6.0
Astra Giurgiu,104,74,77,255,1.329412,1.152941
Braga,159,56,77,292,1.69863,1.109589
Vlla Shkoder,1,1,5,7,0.857143,1.857143
Le Poire/vie,5,2,4,11,1.272727,1.545455
Sete,3,1,3,7,1.285714,1.0
Tunbridge Wells,0,3,4,7,1.285714,2.714286
E Thurrock,96,63,98,257,1.688716,1.587549
Illueca,0,0,1,1,0.0,2.0
Peralada,0,0,1,1,0.0,1.0
AR Sao Martinho,0,0,1,1,2.0,3.0
NAC Breda,17,21,48,86,1.046512,1.895349
Kukesi,15,12,17,44,1.159091,1.340909
Consett,8,1,3,12,2.583333,1.25
Wycombe W,1,0,0,1,3.0,0.0
West Essex,0,0,1,1,1.0,2.0
SJK,71,44,72,187,1.15508,1.117647
N Macedonia,22,12,21,55,1.418182,1.163636
Eritrea,0,0,4,4,0.5,2.25
Holmesdale,0,0,1,1,2.0,4.0
AGF,0,0,1,1,2.0,3.0
Sanf Hiroshima,3,0,1,4,1.75,0.5
Edinburgh Uni,21,24,63,108,1.018519,2.194444
Trencin,32,6,14,52,2.038462,1.326923
Kottmannsdorf,0,0,1,1,0.0,9.0
Hibernian,154,80,71,305,1.704918,1.081967
Cleethorpes T,16,2,6,24,1.833333,1.666667
Vitre,4,7,2,13,1.230769,1.0
West Auck T,12,1,5,18,1.833333,1.277778
Turkey U21,0,1,2,3,0.333333,1.0
Deutschlandsberger,0,0,1,1,0.0,7.0
AD Ceuta,0,1,2,3,0.333333,2.333333
Whyteleafe,2,3,7,12,1.25,2.083333
B Petrolspor,0,0,1,1,0.0,3.0
E Stirling,74,27,71,172,1.790698,1.610465
Hanworth Villa,2,4,3,9,2.222222,2.0
Bassecourt,0,0,1,1,0.0,6.0
City of Liverpool,4,1,5,10,1.7,1.8
Malawi,9,8,11,28,0.607143,0.75
Philadelphia U,77,40,74,191,1.539267,1.429319
Matlock,97,47,111,255,1.435294,1.572549
Vasco,0,0,1,1,1.0,6.0
Southport,81,67,121,269,1.230483,1.561338
Corinthian,10,2,4,16,2.5,2.0
Bray,68,35,91,194,1.170103,1.515464
Algeria Olympic,0,1,2,3,1.333333,2.0
Silsden,1,1,2,4,1.75,2.5
Sp C Thamesmead,1,0,2,3,1.333333,2.333333
Team Wellington,0,1,0,1,3.0,3.0
Breno,0,0,1,1,0.0,2.0
Vila Real,0,0,1,1,0.0,6.0
Pogon Szczecin,82,69,78,229,1.248908,1.248908
Delta Porto Tolle,0,0,1,1,0.0,3.0
Cumnock,0,1,1,2,2.5,3.0
Leith Athletic,1,1,1,3,1.333333,0.666667
Sautron,0,0,1,1,0.0,1.0
Monterosi,0,0,1,1,0.0,1.0
Skenderbeu,40,13,17,70,1.871429,1.028571
MOL Vidi,129,63,63,255,1.623529,0.960784
Gillingham,118,94,123,335,1.340299,1.408955
Inverurie Locos,73,14,30,117,2.717949,1.393162
Kendal Town,5,0,7,12,1.333333,2.083333
Vodojaza,0,0,1,1,0.0,6.0
River Plate,2,1,1,4,1.75,1.25
Thamesmead T,5,1,3,9,1.666667,1.222222
Varea,0,0,2,2,1.0,3.5
Leek,8,2,6,16,2.0625,1.625
Auxerre AJ II,1,1,1,3,1.333333,2.0
Clitheroe,4,0,6,10,1.1,1.9
Pully Football,0,0,1,1,1.0,4.0
Energiya Kh,2,9,21,32,0.5,1.71875
Riga FC,16,5,6,27,1.925926,0.851852
Phoenix Sports,4,2,8,14,1.214286,1.928571
Jumilla,1,0,4,5,0.4,1.8
Leca,0,0,1,1,1.0,3.0
Spain Women,3,3,3,9,1.333333,0.888889
Real Aviles,0,0,1,1,0.0,4.0
Blackburn,125,90,116,331,1.398792,1.238671
Lancing,5,3,3,11,1.909091,1.727273
Aubagne,2,3,2,7,1.428571,1.142857
Limonest,3,4,2,9,0.888889,0.666667
Civil Serv Strol,44,21,41,106,1.54717,1.59434
Deportivo Olim,2,3,4,9,1.0,1.555556
FC Vac,0,0,1,1,1.0,3.0
Santa Tecla FC,1,0,1,2,1.0,2.5
Portugal,46,21,11,78,2.051282,0.74359
South Park,6,4,5,15,2.266667,2.4
Fabregues,0,0,4,4,0.25,2.25
Valerenga,69,50,62,181,1.475138,1.375691
Bayern Alzenau,1,0,1,2,1.0,2.0
Austria Women,0,0,1,1,0.0,2.0
Colomiers,0,2,3,5,0.8,1.8
Cradley Town,0,0,1,1,0.0,1.0
SP Domagnano,0,0,1,1,2.0,3.0
Walton Casuals,28,17,47,92,1.434783,1.923913
1. FC Duren,0,0,1,1,0.0,3.0
Wycombe,131,82,119,332,1.283133,1.298193
Wolfsberger,84,55,99,238,1.298319,1.491597
Lorca Dep.,1,0,5,6,1.0,2.333333
Hungary U21,0,2,4,6,1.0,3.0
Eskisehirspor,14,11,28,53,1.207547,1.773585
Gravelines,0,0,1,1,0.0,3.0
Royal Knokke,1,0,0,1,2.0,1.0
Seychelles,0,2,16,18,0.333333,3.222222
Hereford Lads Club,1,0,1,2,1.5,1.5
Penrith,2,0,3,5,0.8,1.8
Louhans-Cuiseaux,0,0,1,1,0.0,2.0
Tooting & M Wan,0,0,1,1,0.0,9.0
Georgia U21,0,0,1,1,0.0,3.0
Smethwick,0,0,1,1,0.0,3.0
Sabail,0,0,2,2,2.0,3.0
Ravenna,1,1,1,3,1.0,1.0
Angrense,0,0,1,1,0.0,2.0
Union Berlin,87,64,66,217,1.539171,1.331797
Bugbrooke St Michaels,0,0,1,1,1.0,2.0
Canterbury City,10,1,5,16,2.1875,1.625
1299 Osmanlispor,41,33,45,119,1.394958,1.302521
Cottbus,0,2,3,5,1.0,2.2
DR Congo,20,24,17,61,1.42623,1.114754
Saint-Louis N,0,5,4,9,0.888889,2.0
Falkirk U20,0,0,1,1,2.0,3.0
W Bremen,86,61,97,244,1.508197,1.627049
Oostende,85,58,102,245,1.416327,1.567347
Shaftesbury T,1,0,2,3,1.666667,2.0
Werder Bremen II,3,0,2,5,2.2,2.4
Racing,18,23,39,80,0.9625,1.3625
MS Ashdod,51,57,75,183,1.054645,1.349727
Fraserburgh,80,13,27,120,2.991667,1.2
Hebburn Town,12,2,2,16,2.3125,1.0625
Lithuania U21,0,1,0,1,0.0,0.0
Ap Limassol,53,24,27,104,1.894231,1.153846
Norwich U21,8,4,9,21,1.714286,1.904762
Buchbach,0,0,1,1,0.0,4.0
Luxembourg,15,9,35,59,0.881356,1.813559
Hereford,81,42,43,166,1.650602,1.168675
Lecco,0,0,1,1,0.0,2.0
Ashton Athletic,3,0,2,5,1.8,1.2
Murcia,9,4,9,22,1.227273,1.318182
Riviere-Pilote,0,0,1,1,0.0,2.0
NSI Runavik,11,7,15,33,1.515152,1.848485
Crossgates P,1,0,2,3,1.666667,3.333333
Jarrow,0,2,1,3,0.666667,1.333333
Brockenhurst,3,1,5,9,2.0,3.0
Ross County,107,63,113,283,1.431095,1.480565
Real Madrid B,0,2,0,2,0.0,0.0
Sri Lanka,1,0,9,10,0.4,2.2
Chicago,52,50,79,181,1.458564,1.574586
Brazil,50,15,7,72,2.069444,0.486111
Ankaragucu,28,26,48,102,1.088235,1.598039
Warrington,98,51,48,197,1.57868,1.13198
C. Budejovice,21,16,38,75,1.2,1.773333
Verona,54,49,88,191,1.141361,1.596859
Lowestoft,49,36,77,162,1.234568,1.722222
Pieta,1,0,0,1,3.0,0.0
Basford United,50,15,32,97,1.85567,1.402062
Salmrohr,0,0,2,2,0.0,5.5
Bergantinos,0,0,1,1,0.0,1.0
Dynamo Berlin,0,0,3,3,0.333333,4.333333
Kalloni,9,12,28,49,0.857143,1.632653
San Carlos,0,0,2,2,1.5,3.0
KSV Hessen Kassel,1,0,1,2,1.0,1.5
FC Marek,2,1,10,13,0.461538,2.538462
Entente SSG,2,4,6,12,0.5,1.166667
Viry-Chatillon,3,0,2,5,1.4,2.2
Swansea,114,69,118,301,1.27907,1.325581
Radnicki Nis,109,57,68,234,1.384615,1.081197
Chorley,111,81,90,282,1.425532,1.262411
B36 Torshavn,16,12,14,42,1.547619,1.5
Oxford City Nomads,0,0,1,1,2.0,4.0
Galway,1,0,3,4,1.0,1.75
Hadley,3,2,2,7,1.571429,1.142857
Sarajevo,28,6,16,50,1.58,1.02
Viimsi II,0,0,1,1,0.0,13.0
Rakow Czestochowa,30,12,21,63,1.460317,1.269841
Bonnyrigg Rose,38,6,7,51,2.803922,0.980392
Barquereno,0,1,0,1,1.0,1.0
Grenoble,4,10,7,21,0.761905,0.952381
Montlingen,0,0,1,1,0.0,3.0
Zaglebie Sos,7,8,22,37,1.324324,2.162162
FCD Annecy,2,3,4,9,1.111111,1.666667
Molde,124,44,57,225,2.017778,1.177778
Inverness CT U20,0,0,3,3,0.333333,3.0
Formartine Utd,89,17,31,137,2.919708,1.19708
San Marino U21,0,0,3,3,0.0,4.0
Hoddesdon,2,1,4,7,1.428571,1.857143
Risborough Rangers,0,1,2,3,0.0,1.0
Leeds,139,67,105,311,1.392283,1.176849
Bury,88,57,95,240,1.320833,1.395833
Chalfont St P,4,4,5,13,1.692308,1.538462
Dover,122,67,102,291,1.463918,1.33677
Preston Ath.,2,1,6,9,1.222222,2.333333
Academia,0,0,3,3,0.666667,5.333333
Hallam,3,0,5,8,1.625,2.25
Crawley,101,73,152,326,1.196319,1.552147
Coalville,36,19,50,105,1.609524,1.838095
Venezuela,18,20,23,61,1.147541,1.311475
Yate,14,11,28,53,1.320755,1.962264
IK Start,22,31,70,123,1.03252,1.95122
Morton,101,75,94,270,1.344444,1.27037
Samaritaine,0,0,1,1,0.0,2.0
Ludogorets,169,76,50,295,1.918644,0.833898
Ashton Town,0,0,1,1,0.0,4.0
Preussen Mun,1,1,4,6,1.0,1.166667
Banstead Ath,1,0,2,3,2.666667,1.666667
Akhisar Spor Kulubu,0,0,1,1,0.0,1.0
FK Skopje,0,1,2,3,0.666667,2.333333
Accrington,138,84,113,335,1.414925,1.346269
FK Iskra,0,2,1,3,0.333333,0.666667
Inverkeithing BC,0,0,1,1,2.0,6.0
Dunstable,43,27,94,164,1.067073,1.993902
Le Mee,1,0,0,1,2.0,0.0
Paulton,24,19,37,80,1.1375,1.65
Udinese,77,58,123,258,1.147287,1.484496
Vietnam,9,7,7,23,1.26087,1.086957
Lusitano GC E,0,0,1,1,0.0,6.0
Kettering,93,44,65,202,1.881188,1.356436
Levadia Maardu,0,0,1,1,0.0,6.0
Portadown,30,23,71,124,1.048387,1.879032
Argentina,42,19,12,73,1.876712,0.849315
Pontivy,0,0,1,1,0.0,4.0
Vorskla Poltava,75,50,74,199,1.125628,1.19598
F91 Dudelange,49,17,28,94,2.159574,1.425532
Albinoleffe,2,1,3,6,1.333333,1.333333
Saltdean United,1,1,2,4,1.5,1.75
Rusadir,0,0,1,1,1.0,2.0
Colne,7,0,6,13,2.0,2.230769
Tritium,0,0,1,1,1.0,2.0
Al Nassr,0,0,1,1,1.0,2.0
Sunderland U21,3,5,13,21,0.714286,2.095238
Macclesfield,104,75,97,276,1.282609,1.278986
Ely City,4,0,2,6,2.166667,1.666667
Ronse,0,0,1,1,0.0,3.0
Roeselare,2,1,7,10,1.7,2.2
Veres Rivne,7,14,12,33,0.848485,1.030303
V Guimaraes,99,62,89,250,1.38,1.268
AFC Totton,4,4,6,14,1.857143,2.142857
Liverpool,201,86,67,354,1.912429,1.031073
US Esch,0,0,1,1,0.0,3.0
Droylsden,3,6,6,15,1.6,1.866667
FC Eintracht Norderstedt,0,0,3,3,0.333333,4.0
Kuwait,8,6,14,28,1.392857,1.214286
Shakhtyor,126,47,36,209,1.760766,0.736842
South Sudan,3,3,11,17,0.882353,2.176471
Uni Craiova,110,62,74,246,1.272358,0.987805
Kidderminster,100,60,102,262,1.442748,1.328244
Ghetto,0,0,1,1,1.0,8.0
Omonia Nicosia,16,15,23,54,1.203704,1.240741
Tower Hamlets,0,1,1,2,2.0,2.5
Iraklis Salonika,14,22,24,60,0.866667,1.183333
Sambenedettese,2,2,3,7,1.571429,1.571429
Slough,121,62,91,274,1.678832,1.405109
Recreativo,8,9,17,34,0.794118,1.323529
Ivory Coast,30,21,13,64,1.3125,0.796875
Salisbury FC,57,25,23,105,2.238095,1.457143
Norway U21,1,1,4,6,0.833333,2.5
Kruoja,0,1,2,3,0.666667,3.666667
Northwood,2,4,5,11,1.727273,2.545455
Stuttgart,93,48,94,235,1.459574,1.52766
Cacereno,1,1,2,4,0.75,1.25
SC Verl,8,4,4,16,1.5625,0.9375
Boca Juniors (Gib),0,0,1,1,0.0,10.0
Halesowen,60,48,75,183,1.174863,1.469945
Fiji Olympic,0,0,3,3,0.333333,7.666667
R Majadahonda,14,11,26,51,1.019608,1.392157
Guastatoya,0,0,2,2,0.5,1.5
Palermo,28,28,56,112,1.107143,1.6875
Camelford,0,0,3,3,0.666667,2.666667
Shaw Lane,34,10,19,63,1.920635,1.571429
Grimsby,117,82,134,333,1.21021,1.306306
Hertford Town,2,0,7,9,1.333333,3.111111
NK Celje,88,65,78,231,1.341991,1.251082
Velbert,1,0,1,2,1.5,2.5
St-Etienne,113,79,99,291,1.254296,1.24055
Aylestone Park,0,1,2,3,1.333333,3.333333
Mosta,1,0,2,3,2.333333,1.333333
FF Jaro,6,11,16,33,0.818182,1.30303
Everton,119,72,100,291,1.460481,1.329897
Nuneaton,64,50,86,200,1.35,1.565
Mirandes,67,62,76,205,1.190244,1.321951
At Baleares,0,3,3,6,0.666667,1.166667
Welling,85,53,121,259,1.34749,1.517375
Gaziantepspor,22,18,48,88,0.886364,1.647727
Abingdon United,0,0,5,5,0.8,3.2
Krupa na Vrbasu,1,4,2,7,0.857143,1.571429
Peterboro' NS,2,1,4,7,1.0,2.285714
V Reykjavik,0,1,3,4,0.25,2.5
Piacenza,2,2,3,7,1.142857,1.428571
Athlone Town,28,30,107,165,1.048485,2.345455
Estonia U21,0,0,2,2,0.0,4.0
Koralas,0,0,1,1,0.0,4.0
Hullbridge S,6,1,8,15,1.466667,2.133333
Stansted,2,0,2,4,1.5,1.75
Olot,4,3,3,10,1.3,1.6
Portugal U21,12,6,4,22,1.863636,0.863636
Imolese,1,2,3,6,1.333333,2.333333
Dronfield Town,1,0,3,4,1.0,3.5
Diosgyor,65,43,101,209,1.177033,1.593301
Gjilani,1,0,2,3,1.666667,2.666667
Montenegro,17,12,24,53,1.207547,1.377358
Warta Poznan,11,3,12,26,1.038462,1.076923
Worthing United,1,0,1,2,1.5,2.0
FC Nitra,1,2,0,3,1.0,0.666667
Rhyl,20,21,37,78,1.230769,1.846154
Barkingside,0,0,1,1,0.0,5.0
Falkirk,117,73,78,268,1.511194,1.156716
Cantolagua,1,0,1,2,0.5,2.5
Ranheim,20,12,29,61,1.360656,1.721311
Institute FC,15,18,55,88,1.022727,2.181818
Clydebank,0,0,1,1,0.0,4.0
Peterborough,151,77,116,344,1.616279,1.31686
Celtic,254,62,55,371,2.239892,0.816712
Harrogate R,0,0,4,4,0.5,3.5
Alaves,101,65,108,274,1.072993,1.255474
Fylkir,1,2,3,6,0.833333,1.0
Kalev Sillamae,2,1,6,9,1.444444,3.0
NS Mura,41,37,28,106,1.40566,1.037736
Saffron Dynamo,1,1,1,3,2.0,2.666667
Sittingbourne,5,4,5,14,1.0,0.785714
Elfsborg,75,61,56,192,1.614583,1.427083
Sable,0,1,1,2,1.5,3.0
Hartberg,32,22,41,95,1.452632,2.031579
Wasquehal,0,0,1,1,0.0,1.0
Blyth Sptns,132,44,94,270,1.848148,1.474074
Petershill,0,0,2,2,0.0,6.5
Man City U21,14,11,14,39,1.871795,1.589744
Rocester,1,0,3,4,3.0,3.25
Sun Sports,2,2,1,5,1.6,1.6
Oxhey Jets,1,0,3,4,2.0,2.5
Brightlingsea R,40,33,71,144,1.180556,1.722222
Hercules,3,5,4,12,1.083333,1.416667
Ajaccio II,0,0,1,1,0.0,2.0
Congleton Town,4,3,4,11,1.818182,1.818182
Frenford,1,0,1,2,2.5,2.5
Guildford City,2,1,0,3,2.666667,1.666667
Saint-Lo Manche,0,1,0,1,1.0,1.0
Norwich U23,5,1,6,12,1.583333,1.083333
Breidablik,2,4,6,12,1.333333,1.583333
Padiham,1,0,3,4,0.75,1.25
Dinamo Tbilisi,16,3,12,31,1.580645,1.290323
Shrewsbury,134,92,124,350,1.222857,1.205714
Ararat-Armenia,14,0,7,21,1.619048,1.238095
Poggibonsi,0,0,1,1,0.0,3.0
Hansa Rostock,3,2,7,12,0.833333,1.333333
FC Ulisses,0,2,3,5,0.6,2.4
HB Torshavn,9,7,11,27,1.592593,1.37037
RC Lorrain,0,0,1,1,1.0,3.0
Merstham,79,50,106,235,1.408511,1.697872
Ireland U21,0,0,1,1,0.0,2.0
Gallia Lucciana,1,0,0,1,4.0,0.0
Gozzano,0,1,0,1,0.0,0.0
AFC Sudbury,21,14,30,65,1.492308,1.784615
Brighouse Town,2,0,8,10,1.2,2.8
Australia,29,15,13,57,2.0,0.929825
Alvechurch,5,1,6,12,1.5,1.5
Lobon,0,0,1,1,0.0,2.0
Valladolid,99,83,102,284,1.239437,1.225352
Wiener Neustadt,3,5,11,19,1.0,1.947368
Saint-Brice,0,0,1,1,0.0,1.0
Astoria Walldorf,5,3,4,12,1.75,1.416667
Redcar Athletic,0,0,1,1,1.0,2.0
El Alamo,1,0,1,2,1.0,1.0
Din Zagreb,201,59,49,309,1.847896,0.783172
Newton S,0,0,1,1,0.0,4.0
Duisburg,32,30,58,120,1.183333,1.758333
Sandefjord,28,26,66,120,1.166667,1.825
TuS Dassendorf,0,0,2,2,0.0,2.0
Billingham S,0,0,1,1,0.0,1.0
Bourg en Bresse,2,2,4,8,1.0,1.375
New Caledonia,6,5,4,15,1.466667,1.333333
Colney Heath,3,3,4,10,1.4,1.5
Ahrobiznes Volochysk,1,0,0,1,1.0,0.0
Halifax,116,93,104,313,1.341853,1.297125
Paraguay,12,19,25,56,0.964286,1.464286
Lusitano FCV,0,0,1,1,1.0,4.0
Maldives,4,0,13,17,0.882353,2.647059
Chelsea,201,76,76,353,1.838527,1.042493
Iceland Women,1,1,0,2,2.0,1.5
Karlskrona,0,1,2,3,1.0,2.666667
Arka Gdynia,42,42,67,151,1.205298,1.463576
White Ensign,1,0,1,2,3.0,3.0
Stapenhill,0,1,0,1,2.0,2.0
Thurrock,20,7,26,53,1.566038,1.773585
Cagliari,75,51,110,236,1.224576,1.597458
Dundee U U20,1,0,1,2,2.0,2.5
Yorkshire Amateur,2,1,1,4,2.25,1.75
1860 Munich II,0,1,0,1,1.0,1.0
Thun,62,59,88,209,1.425837,1.708134
Saint-Malo,7,1,2,10,2.0,0.8
Squires Gate,1,0,1,2,1.5,1.5
Melton Town,0,0,1,1,2.0,3.0
Holstein Kiel,58,46,42,146,1.767123,1.349315
TSV Steinbach,1,2,3,6,1.0,1.5
Didcot Town,9,6,10,25,1.8,1.56
Salernitana,7,11,12,30,1.266667,1.5
Malatyaspor,42,40,58,140,1.242857,1.378571
Preston,128,92,110,330,1.327273,1.206061
Zira,4,8,12,24,0.875,1.833333
Hoffenheim,93,75,86,254,1.688976,1.507874
St Andrew's,3,1,6,10,1.8,2.6
Sheff Wed,122,92,119,333,1.219219,1.207207
Bonaire,0,0,1,1,0.0,6.0
Blackburn U23,4,2,4,10,1.1,1.0
Afghanistan,4,2,12,18,0.833333,2.833333
Waltham Abbey,4,0,5,9,1.444444,2.555556
Zeta,7,4,3,14,1.357143,0.928571
Freiburg,89,59,86,234,1.435897,1.504274
Radstock Town,0,0,1,1,0.0,1.0
Kizilcabolukspor,0,0,1,1,0.0,4.0
San Jose,55,47,83,185,1.308108,1.708108
B Munich,244,46,40,330,2.624242,0.90303
Canvey Isl.,43,36,56,135,1.474074,1.859259
Stowmarket,8,1,2,11,2.454545,0.454545
Sp Bengal Utd,1,0,2,3,2.333333,3.333333
Solihull M,126,72,111,309,1.433657,1.255663
Hyeres,0,1,0,1,0.0,0.0
Zestafoni,0,0,1,1,0.0,3.0
Cogenhoe Utd,4,1,3,8,1.75,1.875
Guinea,12,12,16,40,1.25,1.375
Alki Oroklini,0,0,4,4,0.25,2.75
Wythenshawe Town,2,3,1,6,2.0,1.666667
Hornchurch,50,35,42,127,1.708661,1.338583
Portland Timb.,83,49,66,198,1.565657,1.424242
Breitenrain,0,0,2,2,1.0,3.5
RM Hamm Benfica,0,0,5,5,2.2,4.6
SV Darmstadt,73,55,90,218,1.334862,1.490826
East Grinstead Town,4,0,6,10,1.7,2.0
Lesmahagow Jnrs,0,0,2,2,1.0,7.5
Maximoise,0,0,1,1,1.0,3.0
Lok Stendal,0,0,1,1,0.0,5.0
UCD,79,40,70,189,1.650794,1.428571
Weymouth,134,79,87,300,1.69,1.253333
Bridgwater T,6,4,5,15,2.2,1.866667
Hamilton U20,6,4,4,14,1.785714,1.142857
Slavija,0,0,1,1,2.0,3.0
Hard,0,0,1,1,0.0,3.0
Yeovil,98,88,138,324,1.203704,1.441358
Synot,69,55,77,201,1.20398,1.303483
Dunfermline,117,70,85,272,1.599265,1.165441
AE Zakakiou,0,0,2,2,0.5,5.5
West Brom U21,3,2,19,24,0.875,2.375
Harefield United,0,0,2,2,0.0,2.5
Montpellier,95,71,91,257,1.299611,1.284047
CP Merida,0,1,0,1,1.0,1.0
Almondsbury T,1,0,1,2,1.5,1.5
Rakvere Tarvas,0,0,3,3,0.333333,4.0
AEK Athens,129,61,58,248,1.520161,0.866935
JJK Jyvaskyla,6,8,19,33,0.969697,1.909091
N Forest U23,0,1,1,2,1.0,4.5
Bristol C,129,81,123,333,1.36036,1.288288
Dacia,10,4,9,23,1.73913,1.478261
Irlam FC,4,0,5,9,1.666667,1.888889
E. Ettelbruck,0,0,8,8,0.625,3.375
Olbia,0,0,1,1,0.0,4.0
ES Tunis,1,1,1,3,2.333333,1.333333
TuS Koblenz,0,0,1,1,2.0,3.0
SSV Ulm 1846,8,3,6,17,1.823529,1.470588
Sochi,21,16,20,57,1.45614,1.210526
Australia Women,3,1,4,8,2.0,2.125
SSV Jeddeloh II,0,0,1,1,2.0,5.0
KFCO Beerschot-W,17,11,26,54,1.537037,1.925926
Paganese,0,0,1,1,0.0,6.0
ND HIT Gorica,63,47,86,196,1.168367,1.413265
Montserrat,0,3,1,4,1.5,1.75
Nancy II,1,0,0,1,2.0,1.0
Fatih Karagumruk,13,11,12,36,1.388889,1.277778
Belchatow,2,3,14,19,1.052632,2.421053
Guingamp,66,55,86,207,1.15942,1.47343
Drancy,1,0,3,4,1.25,2.0
Rio Ave,84,66,81,231,1.220779,1.246753
Hamilton,66,68,139,273,1.058608,1.688645
Brimsdown,0,0,1,1,0.0,3.0
Scotland Women,3,2,2,7,1.571429,1.428571
Grande Synthe,0,0,1,1,0.0,1.0
Latvia,8,18,32,58,0.862069,1.655172
Rugby,2,3,7,12,1.25,1.916667
Blackstones,0,0,1,1,2.0,4.0
Haro Deportivo,2,0,3,5,1.2,1.6
Metalac,28,37,41,106,1.0,1.283019
Maritimo,75,52,102,229,1.026201,1.371179
Ki Klaksvik,11,6,8,25,1.6,1.32
S'ampton U23,8,4,4,16,1.6875,1.0625
FC Santa Coloma,13,14,11,38,1.105263,1.078947
Wellington,55,36,80,171,1.444444,1.719298
Derby U23,2,1,8,11,1.272727,2.363636
Fort William,5,9,87,101,0.811881,5.356436
Tamaraceite,1,0,1,2,1.5,1.5
Pinchbeck United,0,0,1,1,0.0,3.0
Milsami Orhei,13,3,17,33,1.272727,1.424242
Angola,12,9,14,35,0.942857,1.114286
Tallinna FC Infonet,9,1,6,16,2.3125,1.4375
Steenvoorde,0,0,1,1,2.0,4.0
Pro Piacenza,0,0,1,1,1.0,4.0
Rumilly Vallieres,3,5,1,9,1.666667,0.666667
Most,0,0,1,1,1.0,3.0
Las Rozas,2,0,2,4,1.75,2.0
Haywards H'th T,7,1,6,14,1.285714,1.857143
Swift,0,0,1,1,1.0,4.0
Freiburg II,0,1,0,1,1.0,1.0
Czech Rep. U21,8,3,7,18,1.777778,1.555556
Victoria Rosport,1,2,5,8,1.125,2.875
Turriff U,32,15,71,118,1.635593,2.525424
Agro,0,0,1,1,1.0,5.0
Switz'land U21,2,0,2,4,1.75,1.75
FC Guria Lanchkhuti,0,0,1,1,2.0,3.0
Bath City,107,66,93,266,1.454887,1.25188
Portmarnock,0,0,1,1,0.0,2.0
Llanelli,4,4,24,32,0.96875,3.25
Andorra,4,11,38,53,0.283019,1.981132
Dalbeattie Star,17,20,65,102,1.166667,2.382353
Amiens,33,32,60,125,0.992,1.464
Ried,34,24,59,117,1.059829,1.57265
Bashley,2,0,4,6,1.5,2.333333
Guernsey,0,0,3,3,0.333333,2.0
Zrinjski Mostar,20,10,12,42,1.309524,0.904762
Casertana,3,1,5,9,1.222222,2.111111
Basildon United,6,3,5,14,2.071429,2.285714
Millwall,137,98,111,346,1.294798,1.199422
Tabor,0,0,1,1,0.0,3.0
AEL Limassol,8,9,14,31,1.096774,1.645161
Beitar J'salem,107,69,74,250,1.452,1.18
Hengrove Athletic,2,1,3,6,1.833333,2.833333
Mayo League,0,0,2,2,1.5,3.0
Ararat,2,1,7,10,1.3,2.0
Eastwood Com,5,0,3,8,1.875,2.625
Neman Grodno,67,44,71,182,1.021978,1.126374
FC Viktoria 1889,0,0,1,1,0.0,1.0
Spicul Chis,0,0,2,2,0.0,4.5
HJK Helsinki,113,59,39,211,1.734597,0.905213
TB/FCS/ROYN,0,0,1,1,0.0,3.0
FC Yerevan,0,0,1,1,1.0,2.0
Lugo,82,96,104,282,1.021277,1.237589
Gimnastic,56,53,72,181,1.082873,1.287293
Levanger,0,0,1,1,2.0,4.0
Club Brugge,172,61,75,308,1.850649,1.071429
Linlithgow Rose,22,2,12,36,2.388889,1.777778
Denizlispor,15,18,36,69,0.927536,1.565217
Zeljeznicar,15,7,11,33,1.151515,0.939394
Seville II,2,2,0,4,2.0,1.0
Bnei Yehuda,70,62,84,216,1.097222,1.171296
Apoel Nicosia,76,35,47,158,1.689873,1.006329
Montrose,104,53,103,260,1.392308,1.580769
Mladost Pod.,12,4,12,28,1.571429,1.428571
Slaven,59,75,96,230,1.047826,1.321739
Wisla Plock,60,45,70,175,1.302857,1.451429
Shepshed D,10,0,5,15,2.733333,2.066667
Wolves U21,9,6,14,29,1.448276,1.793103
Croydon Ath,1,1,2,4,2.5,3.5
Nimes II,1,0,0,1,2.0,0.0
Rukh Vynnyky,4,8,10,22,0.909091,1.636364
Mensajero,1,0,3,4,0.5,2.0
Ch. Odessa,27,43,69,139,0.776978,1.446043
Viitorul C,102,64,81,247,1.396761,1.190283
Le Mans,9,3,8,20,1.7,1.75
Makedonija,0,0,4,4,0.25,3.25
Heather St J,1,0,3,4,1.5,2.25
Kesla FC,1,3,5,9,0.888889,2.222222
Dieppe,0,0,1,1,1.0,3.0
Celta Vigo,99,81,107,287,1.376307,1.484321
Winsford Utd,0,0,2,2,0.5,1.5
Ingolstadt,45,40,70,155,1.174194,1.445161
Ujpest Dozsa,76,64,73,213,1.333333,1.352113
Aus. Vienna,97,55,96,248,1.564516,1.443548
Perugia,15,10,16,41,1.585366,1.682927
Gr Yarmouth T,1,0,3,4,1.5,2.0
Totton & Eling,0,0,1,1,0.0,2.0
Servette,24,21,23,68,1.426471,1.382353
Noisy Le Grand,3,0,1,4,1.5,1.0
FC Still 1930,0,0,1,1,0.0,1.0
AZ Alkmaar,140,54,67,261,1.931034,1.298851
Banks o'Dee,6,1,5,12,2.5,2.083333
Wivenhoe Town,0,0,1,1,1.0,7.0
SV Atlas Delmenhorst,0,0,1,1,1.0,6.0
Laverstock & Ford,0,0,1,1,1.0,3.0
Sutton Common Rovers,11,2,6,19,2.368421,1.894737
Osijek,110,63,69,242,1.380165,1.020661
Marijampole City,0,0,1,1,1.0,4.0
Brighton U23,5,4,4,13,1.230769,0.923077
Penafiel,2,5,13,20,0.95,2.15
Botosani,90,76,86,252,1.214286,1.130952
Norwich,134,71,107,312,1.483974,1.349359
Truro City,109,54,91,254,1.633858,1.562992
Malvern Town,4,2,3,9,2.777778,3.111111
Neusiedl,1,0,0,1,1.0,0.0
Grosseto,0,0,1,1,2.0,5.0
FSV Frankfurt,10,9,24,43,0.953488,1.744186
Switzerland Women,0,0,1,1,1.0,3.0
Tavistock,8,0,5,13,2.692308,1.384615
FC Utrecht,100,65,67,232,1.702586,1.375
Qormi,0,0,2,2,0.0,2.0
Team Northumbria,2,1,2,5,2.2,1.4
Banga,0,2,0,2,0.5,0.5
Bunol,1,0,1,2,1.0,1.0
Japan Women,1,3,4,8,0.875,1.75
Porto,205,54,47,306,2.019608,0.79085
Stabaek,61,56,67,184,1.375,1.456522
Sheffield FC,1,0,5,6,1.333333,2.166667
Bracknell,9,3,4,16,2.75,1.8125
Llagostera,25,19,32,76,1.092105,1.131579
Cesena,17,9,19,45,1.466667,1.6
Ilves Tampere,77,48,59,184,1.228261,1.190217
Bridport,0,0,2,2,0.0,4.5
Westella & Willerby,0,0,1,1,1.0,5.0
Bolton,90,80,147,317,1.041009,1.495268
Sandbach United,0,0,2,2,1.0,2.5
Neuc. Xamax,14,22,36,72,1.069444,1.861111
Leher TS,0,0,1,1,0.0,5.0
Orleans,13,13,16,42,1.428571,1.452381
Asco,0,0,1,1,0.0,2.0
St Albans,97,61,97,255,1.470588,1.478431
Bergmann Borsig,0,0,1,1,0.0,3.0
Austin FC,0,0,1,1,0.0,2.0
Paget Rangers,1,0,3,4,0.75,2.75
Gibraltar Phoenix,0,0,2,2,0.0,2.5
Cheminots Paray,0,0,1,1,0.0,4.0
Tatran Presov,0,0,2,2,0.5,3.5
Carlton Town,7,1,6,14,1.5,1.571429
Syrianska,1,0,2,3,2.0,5.0
KR Reykjavik,13,10,17,40,1.475,1.6
Besa,0,0,1,1,0.0,2.0
Desna,39,16,34,89,1.438202,1.157303
Abbey Hulton United,0,1,1,2,1.5,2.0
Connah's Q,121,41,60,222,1.68018,1.013514
Alemannia Aachen,0,1,1,2,0.5,2.0
Turkmenistan,7,2,10,19,1.210526,1.578947
Cyprus U21,0,0,1,1,0.0,3.0
Loon-Plage,0,0,1,1,0.0,3.0
Lanusei,0,0,1,1,0.0,2.0
Kairat Almaty,36,7,15,58,1.87931,0.87931
GS Consolat,5,2,8,15,1.333333,1.6
Lambresienne,0,0,1,1,0.0,5.0
Panama Women,0,1,0,1,1.0,1.0
Svyturys,0,0,1,1,0.0,2.0
Murata,1,0,0,1,3.0,1.0
York,91,76,104,271,1.343173,1.428044
Gazovik Orenburg,26,24,42,92,1.0,1.326087
Garforth Town,1,1,2,4,1.25,2.75
Tom Tomsk,5,5,25,35,0.571429,2.028571
Agde,1,0,0,1,3.0,2.0
Tividale,0,0,1,1,1.0,3.0
Martigues,0,0,1,1,1.0,3.0
Dagenh'm,0,1,0,1,1.0,1.0
Paris St-G.,271,43,44,358,2.589385,0.784916
FC Tukums,0,0,1,1,2.0,5.0
Pakistan,1,1,3,5,0.8,1.6
NK Zavrc,15,15,22,52,0.961538,1.25
Otelul Galati,5,5,7,17,1.0,1.235294
Marignane,4,3,2,9,1.333333,1.0
Club Colonial,0,0,1,1,1.0,3.0
Morocco,31,14,15,60,1.333333,0.633333
TuS Haltern,0,0,1,1,0.0,2.0
NK Zagreb,10,9,34,53,0.886792,1.716981
Liverpool U23,2,0,2,4,2.25,1.5
Voluntari,64,65,106,235,1.076596,1.417021
Zemun,17,22,35,74,1.013514,1.337838
Brechin,56,46,148,250,1.056,1.964
Lyngby,41,33,60,134,1.149254,1.567164
Russia,30,15,24,69,1.811594,1.304348
UT Arad,11,10,12,33,0.848485,1.121212
Easington C.W.,0,0,1,1,1.0,3.0
Sant Andreu,2,1,2,5,0.6,1.2
Navalvcarnero,1,0,0,1,3.0,2.0
Zanzibar,1,0,0,1,2.0,1.0
Cornella,5,4,6,15,1.466667,1.4
Valencia II,2,2,3,7,1.142857,1.0
Las Palmas II,0,1,1,2,0.5,1.0
BSC Glasgow,69,21,23,113,2.309735,1.20354
Tunisia U21,0,0,1,1,0.0,2.0
Sawbridgeworth T,0,0,2,2,0.0,2.5
Gemenos,0,1,0,1,1.0,1.0
Ciudad de Lucena,0,0,1,1,0.0,3.0
Haddington Athletic,0,0,1,1,1.0,2.0
Shamrock R B,4,3,11,18,1.166667,1.555556
Sudan,2,2,12,16,0.625,1.625
Ap. Larissa,0,0,2,2,0.0,5.5
SonderjyskE,78,57,86,221,1.321267,1.411765
Sirens FC,0,0,1,1,1.0,2.0
Barnsley,135,82,119,336,1.372024,1.291667
Slovakia U21,6,1,2,9,2.222222,1.111111
Wolverhampton SC,4,1,3,8,2.5,2.125
Avoine OCC,0,1,0,1,1.0,1.0
Romulus,1,4,4,9,1.777778,2.444444
Hawick Royal A,6,4,31,41,1.04878,3.487805
Arsenal Tula,53,35,75,163,1.018405,1.374233
KF Tirana,3,1,4,8,1.0,1.25
C Franciscain,5,1,2,8,1.625,1.625
Ipswich,101,89,128,318,1.103774,1.264151
Luckenwalde,0,0,1,1,0.0,4.0
Altrincham,116,72,112,300,1.53,1.383333
Montceau,0,0,1,1,0.0,3.0
Burntisland S,0,1,2,3,0.666667,6.333333
RB Salzburg,197,58,45,300,2.35,0.95
Hapoel Hadera,33,25,42,100,1.1,1.32
Mjondalen,18,24,48,90,1.133333,1.855556
Challans,1,0,2,3,1.0,1.666667
Swanage T,0,0,1,1,1.0,2.0
Angouleme,1,1,3,5,1.4,2.4
ACS Poli,1,0,2,3,1.0,2.333333
Balingen,0,0,3,3,0.666667,3.333333
Ross County U21,1,0,1,2,2.5,2.5
St Marg'sbury,2,0,1,3,3.666667,2.666667
Platanias,30,28,53,111,0.918919,1.36036
Clanfield 85,0,1,0,1,1.0,1.0
Westerlo,19,23,44,86,1.139535,1.94186
Nomme Kalju,19,10,17,46,1.717391,1.26087
Bishop Auck,1,0,4,5,0.8,1.8
Atherton L R,0,0,1,1,0.0,3.0
FK Pohronie,1,0,2,3,1.333333,2.0
Estrela,0,0,1,1,0.0,4.0
South Korea,44,21,16,81,1.567901,0.82716
Redditch,63,45,61,169,1.485207,1.337278
SC Feignies,0,0,1,1,1.0,2.0
Feirense,26,22,57,105,0.87619,1.533333
Engordany,3,1,6,10,0.7,2.2
Chambly,15,7,12,34,1.352941,1.147059
Chrudim,0,0,1,1,1.0,3.0
H Tel Aviv,55,63,65,183,0.928962,1.125683
Wormatia Worms,0,0,1,1,1.0,6.0
Pontefract C,2,1,5,8,2.375,3.125
Trafford,4,8,18,30,1.0,1.933333
CFR Cluj,140,75,55,270,1.455556,0.788889
Real Betis II,1,2,1,4,1.0,0.75
Guijuelo,5,0,6,11,1.272727,1.727273
FK Riga,2,3,2,7,0.428571,0.571429
Saudi Arabia,31,14,22,67,1.701493,1.149254
Iskra-Stali,1,0,0,1,1.0,0.0
Livingston,126,60,102,288,1.493056,1.173611
Lucerne,93,51,96,240,1.504167,1.525
TPS Turku,14,16,31,61,1.065574,1.57377
Odd Down,2,1,4,7,1.285714,1.857143
Woodbridge T,4,1,3,8,2.375,1.375
Thiers,0,0,1,1,0.0,2.0
08 Villingen,0,0,2,2,1.0,3.5
Kingstonian,107,54,109,270,1.511111,1.511111
Gosport Bor,73,47,126,246,1.211382,1.894309
Derby U21,4,1,5,10,1.3,1.6
Paulhan Pezenas,0,0,1,1,0.0,2.0
Lens II,0,1,0,1,1.0,1.0
Elche,80,85,92,257,1.093385,1.303502
Anagennisis,0,0,1,1,0.0,2.0
Gent,139,72,87,298,1.600671,1.184564
Dundee Utd,131,73,95,299,1.414716,1.244147
Rapperswil-Jona,0,0,1,1,1.0,2.0
Denmark Olympic,1,1,2,4,0.25,1.5
Whitchurch Alport,0,0,1,1,0.0,2.0
Thrapston T,0,0,1,1,3.0,7.0
SV Todesfelde,0,0,1,1,0.0,1.0
Algeria,27,14,13,54,1.87037,1.018519
India,6,6,17,29,1.068966,1.655172
Northern Mariana Islands,0,0,1,1,0.0,8.0
AFC St Austell,8,0,4,12,2.75,2.166667
Tre Penne,13,3,12,28,1.428571,1.714286
Portishead Town,0,0,1,1,1.0,3.0
IA Akranes,1,3,0,4,1.5,1.25
Thurnby Nir,6,1,8,15,2.0,2.0
B-Uhlenhorst,0,0,1,1,0.0,5.0
Hibernian U20,1,1,3,5,2.2,2.2
Mestre,0,1,0,1,2.0,2.0
Kuressare,0,0,1,1,2.0,7.0
Llandudno,36,37,57,130,1.215385,1.592308
Ironi Kiryat S,70,55,96,221,1.072398,1.239819
Bromley,120,74,112,306,1.53268,1.411765
Braintree,98,57,123,278,1.284173,1.467626
SV Sandhausen,63,60,86,209,1.196172,1.354067
Montlucon,0,1,1,2,0.5,1.0
Egypt,31,8,13,52,1.326923,0.653846
Arsenal U21,12,5,8,25,1.84,1.68
H. Petah Tikva,4,6,8,18,1.333333,1.611111
Walsall,113,98,126,337,1.21365,1.341246
AFC Uckfield Town,6,0,3,9,2.666667,2.333333
Macva Sabac,29,29,80,138,0.724638,1.492754
Epsom & Ewell,2,0,3,5,2.6,2.4
Tranent Juniors,4,2,1,7,2.428571,1.714286
OFI Crete,29,26,65,120,1.008333,1.633333
Bristol Manor F,11,1,6,18,2.555556,1.388889
Uerdingen,0,1,1,2,0.0,1.0
Kristiansund,46,37,37,120,1.566667,1.441667
Arges Pitesti,11,11,11,33,1.030303,1.272727
Christchurch,6,2,2,10,1.8,1.1
Pachuca,2,0,1,3,1.666667,0.666667
Cuneo,0,0,1,1,0.0,1.0
IK Brage,1,2,2,5,1.6,2.2
Morecambe,96,88,146,330,1.215152,1.572727
Akademija Pandev,0,0,5,5,0.4,2.8
Shirebrook,1,0,3,4,1.0,2.5
VSG Altglienicke,0,0,1,1,0.0,6.0
Guadalajara,5,3,3,11,1.636364,0.909091
H Beer Sheva,148,75,75,298,1.513423,1.04698
Cameroon,24,28,13,65,1.092308,0.892308
Lugano,73,69,85,227,1.286344,1.493392
Falkenbergs FF,22,24,77,123,1.01626,2.097561
Rossington Main,0,0,1,1,4.0,6.0
San Fernando,2,0,3,5,1.6,2.2
Genk,144,65,78,287,1.763066,1.212544
Beziers,5,4,4,13,1.0,0.692308
Nea Salamis,3,1,10,14,0.928571,2.928571
Etoile Carouge,0,0,1,1,0.0,1.0
Derby,130,95,110,335,1.316418,1.197015
Farnham Town,1,0,2,3,2.0,2.333333
Stip,1,0,2,3,0.666667,1.666667
Worthing,85,44,67,196,1.755102,1.627551
Vannes,0,2,0,2,1.5,1.5
West Allotment,0,0,1,1,3.0,7.0
Pena Deportiva,2,2,4,8,0.75,1.125
Burton Park Wanderers,0,1,0,1,2.0,2.0
Rouen,1,0,1,2,2.0,2.0
St Kitts and Nev,8,3,6,17,1.823529,1.588235
Chesham,117,58,91,266,1.620301,1.406015
Mauritius,3,8,15,26,0.807692,1.961538
Bournemouth,105,64,119,288,1.423611,1.517361
Rwanda,9,8,10,27,1.407407,1.222222
Prestatyn,5,9,31,45,0.933333,2.244444
Zambia,17,14,13,44,1.340909,1.022727
Fjolnir Reykjavik,2,1,3,6,1.5,1.666667
Munsingen,0,0,1,1,0.0,3.0
Vyskov,0,0,1,1,1.0,5.0
Chelsea U23,1,1,3,5,1.6,2.0
Thackley,1,0,1,2,2.0,1.0
Racing (Lux),1,3,6,10,1.4,2.5
Fulham U23,3,0,3,6,1.166667,1.0
Hinckley AFC,7,0,4,11,2.636364,2.0
Benin,9,13,7,29,1.068966,1.241379
Kehlen,0,0,1,1,1.0,7.0
Sainte-Genevieve,0,0,1,1,0.0,3.0
FV Engers 07,0,0,1,1,0.0,3.0
Ath Bilbao II,1,0,0,1,1.0,0.0
Tomares,1,0,1,2,1.5,3.0
Rennes,108,81,98,287,1.299652,1.285714
Cote Bleue,0,0,2,2,1.0,4.0
Sonnenhof G,1,2,2,5,1.2,1.8
Torpedo Minsk,7,9,44,60,0.4,1.733333
Loughbr'gh Dy,1,1,6,8,0.75,2.625
Floresti,0,0,1,1,0.0,1.0
Blackfield & L,14,11,20,45,1.155556,1.688889
Swindon,114,68,143,325,1.323077,1.510769
S Africa Olympic,0,2,1,3,0.333333,0.666667
Kirkley & P,5,0,3,8,2.25,1.625
Grevenmacher,0,0,4,4,0.5,4.0
Fenerbahce,139,72,63,274,1.664234,1.087591
Angers,83,65,95,243,1.131687,1.259259
Villanovense,5,6,11,22,1.0,1.590909
Ethiopia,4,6,9,19,1.157895,1.947368
Prestwich Heys,1,1,1,3,2.0,1.0
Wolverhampton C,2,0,1,3,1.666667,1.0
Team Solent,5,0,3,8,1.875,1.75
Ibiza Islas Pitiusas,0,0,1,1,0.0,2.0
Mechelen,74,43,71,188,1.420213,1.494681
Novara,10,6,10,26,1.692308,1.576923
Leioa,1,1,4,6,0.833333,3.0
Ancona,2,0,2,4,1.5,2.25
Burnham,0,3,19,22,0.681818,2.590909
Red Star Paris,16,11,13,40,1.1,1.0
Nashville MLS,10,10,8,28,1.142857,1.0
Wales,28,13,17,58,1.189655,0.844828
Wick,0,0,2,2,0.0,2.0
Motherwell,112,50,122,284,1.376761,1.457746
Man City,252,52,63,367,2.3297,0.877384
Ath Bilbao,135,86,103,324,1.364198,1.148148
Grindavik,3,0,4,7,1.0,1.285714
Cinderford,13,7,40,60,1.233333,2.266667
Shamkir,0,0,1,1,0.0,2.0
Hollenbach,1,0,0,1,1.0,0.0
Lydney Town,0,0,1,1,1.0,3.0
Shirak Gumri,8,4,12,24,1.208333,1.5
Macarthur FC,8,4,7,19,1.263158,1.421053
Newton Abbot Spurs,1,0,2,3,1.333333,4.0
Inter Miami CF,7,3,15,25,1.08,1.64
Comoros,3,12,10,25,0.88,1.4
Congo,7,13,14,34,1.029412,1.441176
Gran Tarajal,0,0,1,1,0.0,3.0
Benfica (B),1,0,0,1,2.0,0.0
Dag Liepaja,13,4,13,30,1.1,1.133333
Palanga,0,0,2,2,0.0,2.0
Stal Dniprodzerzhynsk,23,25,42,90,0.8,1.177778
Trans Narva,0,2,9,11,0.727273,2.272727
Astana,84,28,42,154,1.681818,1.12987
Dungannon Sw,65,49,118,232,1.176724,1.823276
CD Calahorra,3,2,4,9,0.888889,1.0
Horley Town,4,1,5,10,2.4,2.3
Ellesmere Rangers,0,0,1,1,2.0,3.0
Benfica,206,50,51,307,2.218241,0.879479
Hamble Club,5,1,2,8,2.5,2.125
Jagodina,9,15,28,52,0.923077,1.634615
Al Jazira,1,0,2,3,1.0,2.0
Hammarby,79,52,56,187,1.705882,1.379679
Uganda,18,16,15,49,0.857143,0.673469
Dukla Prague,39,33,67,139,1.158273,1.57554
Spain U21,19,5,2,26,2.423077,0.653846
AFC Dunstable,4,0,6,10,1.6,1.9
Newcastle Jets,53,38,77,168,1.27381,1.565476
Heidenheim,87,60,72,219,1.456621,1.287671
Wettswil-B,0,0,1,1,0.0,2.0
Racing Club Warwick,2,1,2,5,1.4,1.4
Fleet Town,2,1,5,8,1.0,2.0
Bishop's St.,82,42,119,243,1.353909,1.757202
UCAM Murcia,18,16,22,56,1.142857,1.285714
Barton Rovers,3,1,5,9,1.888889,2.0
Panegialios,0,0,1,1,0.0,4.0
Warrenpoint T,41,40,112,193,1.202073,2.170984
Burundi,8,10,9,27,1.481481,1.222222
Arsenal,198,70,91,359,1.857939,1.133705
Bootle,3,0,4,7,2.428571,2.428571
Soham Town R,3,2,7,12,1.416667,2.0
Nice,111,67,96,274,1.328467,1.273723
Sebail,0,1,7,8,0.125,2.375
Saburtalo,7,3,8,18,1.111111,1.5
Greenwich B,3,1,6,10,1.9,2.1
Grantham,89,58,104,251,1.378486,1.609562
Zaria Balti,4,2,12,18,0.833333,2.277778
Cambridge U,120,79,133,332,1.213855,1.28012
Alma Juventus Fano,0,0,2,2,0.5,3.0
RoPS,70,43,74,187,1.15508,1.245989
Crusaders,157,42,56,255,2.121569,1.156863
Drogheda,78,39,77,194,1.458763,1.43299
Nest-Sotra,0,0,1,1,0.0,2.0
Uttoxeter Town,4,2,3,9,2.111111,1.888889
KA Akureyri,0,1,3,4,0.75,1.75
Wellington Amateurs,0,0,1,1,1.0,2.0
Be. Perigord,9,4,6,19,1.368421,1.105263
Rielasingen-A,0,0,2,2,0.5,5.5
Guatemala,14,9,16,39,1.153846,1.589744
Volna,0,0,2,2,2.0,3.5
Bahamas,0,0,4,4,0.0,4.0
Jeanfield S,0,0,1,1,1.0,2.0
Forres Mech,62,16,36,114,2.359649,1.552632
Sanatate Cluj,0,0,1,1,1.0,6.0
Cockfosters,1,0,3,4,1.25,1.75
Germania E/L,0,0,1,1,0.0,6.0
IK Sirius,39,31,56,126,1.373016,1.753968
La Louviere,0,0,1,1,1.0,2.0
Gateshead,109,79,97,285,1.403509,1.273684
Creteil,5,7,5,17,1.529412,1.294118
Dumbarton,74,58,128,260,1.096154,1.692308
Steeton,0,0,1,1,2.0,3.0
B Dortmund II,0,0,1,1,0.0,2.0
Hanwell Town,5,2,6,13,1.538462,1.538462
Sioni,0,0,5,5,1.2,2.8
Poland Women,0,1,1,2,0.5,2.0
Arcahaie,0,1,1,2,0.0,4.0
SV Lippstadt,0,0,1,1,0.0,1.0
KPS Kuopio,85,51,56,192,1.40625,1.083333
Velez Mostar,0,0,2,2,0.0,1.0
Arouca,26,26,42,94,1.074468,1.393617
Harrogate,143,67,100,310,1.7,1.306452
Panevezys,0,0,2,2,0.5,1.5
Ilford,1,0,3,4,2.0,2.25
Swarovski Wattens,16,14,28,58,1.344828,1.844828
Oissel,0,1,1,2,0.5,1.0
R. Rostov,85,59,63,207,1.193237,1.004831
Japan Olympic,1,1,1,3,2.333333,2.333333
St. Truiden,72,58,90,220,1.263636,1.459091
Maag Tammeka,0,2,4,6,0.666667,1.5
Tauro,1,0,3,4,1.0,2.5
Kyrgyzstan,12,3,11,26,1.576923,1.576923
Namibia,9,5,12,26,0.923077,1.153846
Vitebsk,64,51,69,184,1.032609,1.157609
Holland Women,12,1,0,13,2.384615,0.461538
Maynooth Uni,0,0,1,1,0.0,4.0
Portsm'th U23,0,1,0,1,0.0,0.0
Belgium,55,9,8,72,2.847222,0.861111
Bourges Foot,0,0,2,2,0.0,2.0
Qaradag Lok,0,0,1,1,0.0,2.0
WIT Georgia,0,1,1,2,0.0,1.5
Mtsapere,0,0,1,1,0.0,2.0
Newhaven,7,1,4,12,2.083333,1.25
Den Haag,58,55,99,212,1.231132,1.792453
Cyprus,12,7,32,51,0.921569,1.745098
Horsham YMCA,2,0,4,6,2.166667,2.333333
St Clements D,0,0,1,1,0.0,2.0
Austria,33,11,16,60,1.583333,1.016667
Hadleigh United,0,0,1,1,1.0,2.0
Tolosa,1,0,1,2,0.5,1.5
TP Mazembe,0,0,2,2,0.5,2.5
Mogren,1,0,0,1,3.0,0.0
Staveley Miners,2,1,2,5,2.4,2.2
Selkirk,16,3,19,38,2.0,1.894737
07 Vestur,0,0,4,4,0.5,2.5
FSV Union Furstenwalde,0,0,1,1,1.0,4.0
Chateauroux,14,8,16,38,1.289474,1.526316
Ossett Albion,0,4,2,6,0.833333,1.333333
Dukla Bystrica,0,0,3,3,0.333333,1.666667
Toulouse,63,63,109,235,1.102128,1.46383
Spartak Trnava,32,12,23,67,1.552239,1.059701
Acad Coimbra,9,20,27,56,0.928571,1.607143
Pescara,15,18,40,73,1.260274,1.890411
Andrezieux,5,0,4,9,1.555556,1.0
Heybridge,11,5,6,22,2.090909,1.318182
Larne,31,18,15,64,1.796875,1.0
Hallen,1,0,1,2,0.5,0.5
Helsingborgs,32,26,62,120,1.158333,1.616667
Nelson,0,0,1,1,0.0,5.0
Lille II,0,1,0,1,0.0,0.0
Erith Town,3,0,2,5,2.2,1.0
Andorra U21,0,0,2,2,0.0,5.0
Ibiza,8,4,2,14,1.5,0.714286
Ramon y Cajal,0,0,1,1,1.0,2.0
Colomiers US,0,0,1,1,2.0,5.0
Cologne,77,65,98,240,1.504167,1.5375
Canet Roussillon FC,4,5,3,12,1.166667,1.083333
Tarazona,0,1,2,3,0.666667,2.0
Triglav,26,19,63,108,1.148148,2.203704
Kasimpasa,76,50,99,225,1.466667,1.626667
BSG Chemie Leipzig,1,0,1,2,1.0,2.0
Coleraine,119,62,62,243,1.572016,1.135802
Lions Gibraltar,0,0,4,4,0.25,5.25
Coldstream,1,0,3,4,1.0,3.25
Eend. Aalst,0,0,1,1,0.0,4.0
Peterborough Sports,10,1,6,17,2.411765,1.764706
Amorebieta,2,2,4,8,1.125,1.5
Sp Gijon II,0,1,0,1,0.0,0.0
North Korea,13,9,13,35,1.342857,1.542857
Grimsby Borough,3,0,2,5,1.8,1.4
Glacis United,0,1,4,5,0.2,2.2
Varmamo,0,0,1,1,0.0,2.0
London Tigers,0,0,1,1,3.0,9.0
Nairn County,44,13,51,108,1.685185,2.0
R. Vallecano,98,78,100,276,1.293478,1.365942
Whitley Bay,2,2,3,7,3.0,2.571429
VfR Aalen,0,4,5,9,0.444444,1.444444
Coruxo,0,0,2,2,2.0,4.5
Granada,106,63,121,290,1.206897,1.444828
Sleaford Town,4,2,3,9,3.111111,2.666667
Esbjerg,40,39,72,151,1.13245,1.662252
SK Tirana,3,3,9,15,0.933333,1.533333
Gateshead FC,1,0,0,1,2.0,1.0
Akhisar B,49,45,70,164,1.231707,1.439024
Lincoln Utd,4,4,7,15,1.866667,2.133333
Girvan,0,0,2,2,0.5,3.5
Valenciennes,10,7,20,37,1.054054,1.675676
Aalesund,33,26,64,123,1.284553,2.0
Acharnaikos,0,0,1,1,0.0,3.0
Turkey,32,21,14,67,1.507463,1.0
HVV Te Werve,0,0,1,1,0.0,7.0
Poland,33,17,15,65,1.830769,1.015385
Loughbr'gh Un,2,1,4,7,2.428571,2.0
LASK Linz,89,26,43,158,1.829114,1.101266
Giresunspor,0,0,1,1,0.0,1.0
St. Johnstone U20,4,3,5,12,1.5,1.75
Meridian VP,1,0,2,3,1.0,2.333333
Ascot Utd,6,2,5,13,2.615385,1.615385
Real Sociedad II,0,2,1,3,0.333333,0.666667
Ecuador,23,10,25,58,1.603448,1.37931
Hertha II,1,1,0,2,1.0,0.0
Etar Veliko Tarnovo,34,36,54,124,1.040323,1.443548
Cerro Reyes At,0,0,1,1,1.0,2.0
Maceratese,0,1,1,2,3.0,3.5
Bohemians D.,92,43,79,214,1.266355,1.11215
Mondorf-les-Bains,1,1,4,6,1.0,1.666667
FK Trepca,0,0,1,1,0.0,8.0
Blaby & W'stone,1,0,1,2,2.0,4.5
Brunei,3,0,4,7,1.142857,2.0
Hendon,98,63,97,258,1.635659,1.655039
Man Utd U23,2,1,2,5,1.2,1.6
Pardubice,12,6,11,29,1.103448,1.344828
Venissieux,0,0,1,1,0.0,1.0
Compostela,1,0,3,4,1.5,1.5
FSV Zwickau,1,0,4,5,1.2,1.8
Brighton U21,14,11,9,34,1.823529,1.235294
Thatcham Town,19,0,4,23,2.782609,1.173913
B. Munich II,0,1,1,2,1.0,2.0
Flora Tallinn,18,5,12,35,2.514286,1.2
Alverca,1,0,0,1,2.0,0.0
La Roda,0,0,1,1,1.0,4.0
Union St Gilloise,10,3,8,21,2.0,1.571429
PEC Zwolle,68,49,96,213,1.361502,1.704225
Blansko,0,0,1,1,0.0,2.0
Sao Tome & P,2,0,8,10,0.4,2.0
Milan,147,78,78,303,1.551155,1.108911
Sollentuna FK,0,0,3,3,0.333333,4.666667
SO Cholet,1,3,2,6,1.333333,2.166667
APV Strasbourg,0,1,1,2,1.0,1.5
Seyssinet-Pariset,0,0,1,1,0.0,4.0
Watford,111,58,116,285,1.263158,1.385965
Santarcangelo,0,0,1,1,0.0,1.0
Athersley Rec,0,0,1,1,1.0,5.0
Israel,14,8,25,47,1.297872,1.531915
Sandweiler,0,0,1,1,0.0,6.0
Belper United,0,0,2,2,1.5,3.5
Liverpool U21,9,3,8,20,1.9,1.7
Brisbane Roar,64,40,66,170,1.464706,1.6
Nantes II,0,1,3,4,0.5,1.75
Hythe,7,2,6,15,1.533333,1.666667
Mexico Olympic,1,1,1,3,2.333333,1.333333
Southend,105,76,145,326,1.180982,1.457055
Laredo,2,0,4,6,1.333333,1.833333
Banik Ostrava,52,44,80,176,1.170455,1.392045
NK Varazdin,15,16,35,66,0.80303,1.545455
Leverstock Gr,3,0,2,5,3.2,2.2
Paris Atletico,1,0,0,1,1.0,0.0
Aris Limassol,0,0,2,2,0.0,3.5
Ribadumia,1,0,1,2,0.5,1.0
North Shields,11,2,4,17,2.0,1.117647
France Women,8,0,1,9,2.444444,0.666667
Maine Road,1,0,1,2,4.0,2.5
Ukraine,30,15,16,61,1.344262,1.081967
Carterton,1,0,1,2,2.5,2.5
M. Tel Aviv,187,69,52,308,1.698052,0.779221
Heanor Town,2,0,6,8,1.125,2.625
Rushden & H U,0,0,1,1,0.0,2.0
Cowes Sport,0,0,1,1,0.0,2.0
Huracan Val,1,0,1,2,1.0,0.5
Osnabruck,18,22,40,80,1.0875,1.5875
Volos NFC,17,19,27,63,0.920635,1.412698
Fontenay,1,1,0,2,1.5,0.0
Hamworthy United,5,1,3,9,2.666667,1.333333
Zilina,23,4,17,44,2.159091,1.545455
Apollon Smyrni,18,21,53,92,0.706522,1.423913
Arras,0,0,1,1,0.0,2.0
Gabon,7,15,14,36,0.833333,1.166667
Cork City,116,46,65,227,1.590308,0.960352
St Neots,58,48,68,174,1.597701,1.724138
MFK Karvina,39,42,77,158,1.075949,1.518987
Rothwell Cor.,2,0,3,5,1.2,1.8
Raynes Park Vale,2,1,2,5,1.2,2.2
Eastbourne,84,72,106,262,1.469466,1.641221
Farnborough,67,31,107,205,1.502439,2.082927
Radnik Surdulica,68,48,94,210,1.133333,1.480952
Canada Women,5,2,2,9,1.111111,0.444444
Berwick,60,47,130,237,1.075949,1.919831
Badshot Lea,2,0,2,4,1.5,2.5
Wellington AFC,1,0,1,2,3.5,3.0
Britannia,0,0,1,1,0.0,10.0
FK Qarabag,101,40,43,184,1.576087,0.836957
Renova,2,2,10,14,1.214286,2.642857
Ivybridge Town,1,1,2,4,1.75,1.75
Luneburger,0,0,1,1,1.0,3.0
Tuzlaspor,1,0,0,1,2.0,0.0
Union,0,0,1,1,2.0,6.0
Boavista,65,58,96,219,0.936073,1.223744
Maubeuge,0,0,1,1,1.0,3.0
Poole Town,115,59,75,249,1.658635,1.212851
Excelsior,39,38,76,153,1.228758,1.843137
FK Trakai,20,6,8,34,1.852941,1.0
Lorca,10,10,27,47,0.978723,1.680851
Walsall Wood,10,3,6,19,1.842105,1.473684
Thame Rangers,1,0,1,2,3.0,2.5
RC Warwick,1,0,0,1,3.0,2.0
Northwich Manchester Villa,0,1,1,2,1.0,2.0
Gornik Leczna,24,24,44,92,1.108696,1.48913
Rosenborg,138,55,57,250,1.808,1.06
USM Senlis,0,0,1,1,0.0,4.0
Takeley,0,0,3,3,1.0,3.0
France,55,12,11,78,2.025641,0.884615
Vancouver W,68,40,79,187,1.315508,1.588235
Runcorn Linnets,9,4,4,17,2.058824,1.764706
Chievo,52,54,86,192,0.963542,1.447917
Ivory Coast Women,0,1,0,1,1.0,1.0
Stourbridge,90,46,64,200,1.6,1.325
Libya,8,9,12,29,1.310345,1.241379
Brondby,126,52,74,252,1.706349,1.18254
Vitoria Setubal,42,62,91,195,0.923077,1.476923
Galicia,0,1,0,1,1.0,1.0
Staines,61,39,108,208,1.461538,2.173077
N Greenford U,2,1,2,5,2.8,2.8
FC Twente,51,44,79,174,1.350575,1.683908
Holyport,0,1,1,2,0.0,1.5
Gefle,16,15,29,60,1.15,1.783333
Buckie Thistle,61,19,47,127,2.354331,1.716535
Evergreen,0,0,1,1,0.0,4.0
Kuban K,8,15,23,46,1.065217,1.413043
Orihuela,0,2,3,5,0.2,1.0
Nth Ferriby,53,37,82,172,1.19186,1.732558
Mantova,1,1,2,4,1.5,2.25
Dunaujvaros,2,3,8,13,0.846154,1.307692
HNK Gorica,44,29,30,103,1.524272,1.281553
Amkar Perm,31,34,41,106,0.783019,0.990566
Real Oviedo,92,74,87,253,1.181818,1.193676
FC Timisoara,27,39,54,120,0.925,1.5
AD San Juan,0,0,1,1,0.0,2.0
Castellon,13,7,22,42,0.904762,1.190476
Norway Women,5,1,3,9,2.222222,1.222222
Brazil Women,2,0,6,8,1.125,1.375
AE Prat,0,0,1,1,0.0,1.0
Tahiti,6,3,3,12,4.0,0.916667
Pontivy Stade,1,0,1,2,1.5,2.0
Honka,40,28,18,86,1.453488,1.034884
Newtongrange S,0,0,3,3,0.666667,4.0
US Chantilly,0,0,1,1,0.0,4.0
Monaco II,1,0,0,1,3.0,2.0
New York City,89,46,60,195,1.697436,1.374359
Blagnac,1,0,1,2,1.0,1.0
Cheddar,2,0,2,4,1.5,2.25
Kirklarelispor,0,1,1,2,0.0,1.5
Flora Paide,0,1,7,8,0.875,2.875
Daventry Town,0,1,4,5,1.0,2.2
Aire-Sur-La-Lys,0,0,1,1,1.0,4.0
Sweden U21,5,7,5,17,1.529412,1.294118
M Saransk,9,15,19,43,0.906977,1.55814
Thetford T,2,1,2,5,1.2,1.6
Real Valladolid II,0,2,1,3,0.333333,0.666667
Ashby Ivanhoe,0,0,1,1,3.0,5.0
Gloucester,88,59,101,248,1.330645,1.491935
Ossett United,3,0,3,6,1.833333,1.166667
W Mannheim,1,0,2,3,2.0,2.666667
Keynsham Town,0,0,1,1,0.0,4.0
Real Titanico,0,0,1,1,0.0,2.0
Blantyre,0,0,1,1,0.0,4.0
Pandurii,34,29,33,96,1.177083,1.229167
Academia UTM,0,0,1,1,1.0,3.0
Noah,0,0,3,3,0.666667,2.666667
Hearts,121,70,89,280,1.557143,1.196429
Brocton,3,0,4,7,2.428571,2.714286
La Nucia,1,1,2,4,1.0,1.25
Sweden Olympic,0,1,2,3,0.666667,1.333333
Godmanchester,5,1,4,10,1.8,1.8
Panionios,66,47,76,189,0.984127,1.142857
KPV Kokkola,7,7,17,31,1.064516,1.645161
Spakenburg,0,0,1,1,0.0,7.0
Wulfrunians,3,1,3,7,2.142857,2.285714
Balmazujvarosi,8,12,13,33,1.181818,1.393939
Rushden,1,1,2,4,1.0,1.25
Auxerre,28,14,17,59,1.355932,0.949153
Valur,16,5,14,35,1.485714,1.285714
Linares,2,1,4,7,1.428571,1.571429
Central Africa,3,4,7,14,0.928571,1.857143
Plymouth P,11,1,6,18,2.555556,1.722222
FC Kosice,1,0,1,2,0.5,0.5
FK Baku,0,0,1,1,0.0,3.0
Ruch Chorzow,29,21,42,92,1.152174,1.521739
Huntly,40,20,57,117,1.581197,2.34188
Mantes,1,0,3,4,0.5,1.25
Houston Dyn,7,7,8,22,1.272727,1.227273
Ashford United,5,3,5,13,1.692308,1.923077
OFK Belgrade,14,7,31,52,1.038462,1.596154
Wokingham & Emmbrook,0,0,1,1,1.0,3.0
Leonzio,0,0,1,1,0.0,2.0
Westbury Utd,0,1,2,3,1.0,1.666667
Rotherham,95,63,153,311,1.26045,1.588424
Cukaricki,118,59,64,241,1.53112,1.041494
Highmoor Ibis,0,0,2,2,0.5,2.0
LKS Lodz,6,6,25,37,0.891892,1.837838
Crawley Green,1,0,5,6,1.333333,2.333333
Gotene,0,0,1,1,0.0,5.0
Shkupi,1,2,9,12,0.75,2.0
Lordswood,5,0,4,9,1.777778,1.777778
Curacao,16,9,9,34,2.0,0.911765
Exeter U21,0,0,1,1,1.0,2.0
Ashton & Backwell United,0,0,1,1,1.0,2.0
Bourg-Peronnas,11,7,16,34,1.205882,1.970588
Slovenia U21,0,2,2,4,0.5,2.25
Oxford C,102,61,106,269,1.591078,1.550186
VfB Germania H,0,0,2,2,0.5,4.0
Marseille II,0,1,2,3,0.0,1.666667
Harrowby United,0,0,3,3,0.666667,3.666667
Hibernians,11,3,14,28,1.285714,1.5
Sertanense,0,0,1,1,0.0,3.0
Sloga Mravince,0,0,1,1,0.0,1.0
Queen of Sth,98,66,111,275,1.465455,1.436364
Amesbury T,0,0,1,1,0.0,1.0
Teplice,57,57,83,197,1.13198,1.492386
Unterhaching,8,6,9,23,1.521739,1.434783
Gala Fairydean,38,19,55,112,1.5625,1.982143
Pavia,4,4,2,10,1.5,0.8
Pontarlier,0,1,0,1,1.0,1.0
Anorthosis Fam.,6,8,12,26,1.153846,1.538462
Cuba,6,3,15,24,1.166667,2.291667
Rezzato,1,0,1,2,1.5,3.0
Blidworth Welfare,3,1,3,7,2.571429,1.571429
Bolivia,9,10,37,56,0.875,2.25
Wuppertaler,0,0,1,1,2.0,5.0
Leicester U21,21,11,11,43,1.72093,1.232558
B'ham U23,0,0,1,1,1.0,3.0
Reus Deportiu,39,40,63,142,0.711268,0.950704
Benevento,27,19,55,101,1.128713,1.891089
Romorantin,6,2,3,11,1.454545,0.909091
Chaves,31,32,44,107,1.130841,1.476636
Argentina Olympic,1,1,1,3,1.0,1.333333
MK Dons,124,78,137,339,1.318584,1.345133
Stevenage,102,93,133,328,1.161585,1.32622
Bonner SC,0,0,2,2,1.0,4.0
Selby Town,1,0,2,3,2.666667,2.333333
LA Galaxy,69,47,70,186,1.61828,1.655914
Norwich United,2,0,6,8,2.125,2.0
Ambrosiana,0,0,1,1,0.0,4.0
Cumbernauld C,46,28,50,124,1.604839,1.806452
Gillingham Town,1,1,1,3,1.0,0.333333
Hessen Dreieich,0,1,0,1,2.0,2.0
Korabi Peshkopi,0,0,3,3,0.333333,2.666667
Metan Medias,65,68,73,206,1.082524,1.145631
Bodo Glimt,69,36,48,153,1.954248,1.418301
Avranches,7,6,12,25,1.0,1.44
Germany Olympic,3,3,0,6,3.666667,1.0
Al Sadd (Qatar),1,0,2,3,2.333333,3.333333
Jura Sud,1,1,1,3,1.333333,0.666667
NK Ivan. Gorica,0,0,1,1,0.0,3.0
Killester U,0,1,0,1,3.0,3.0
TSV St. Johann,0,0,1,1,0.0,5.0
Vojvodina NS,116,55,74,245,1.338776,1.065306
Alloa,92,66,119,277,1.31769,1.548736
Tring Athletic,7,3,4,14,1.928571,1.142857
Panathinaikos,112,65,66,243,1.337449,0.954733
Banbury,53,36,45,134,1.597015,1.246269
Celtic U20,2,3,4,9,1.444444,2.111111
Hailsham Town,1,0,1,2,1.0,2.0
Cambuur,8,13,33,54,1.0,2.074074
Southampton U21,13,3,14,30,1.5,1.666667
Meyrin,0,0,1,1,0.0,3.0
SV Eichede,0,0,1,1,0.0,4.0
Liechtenstein U21,0,0,2,2,0.5,5.5
Bnei Sakhnin,57,50,80,187,0.946524,1.304813
Monza,4,1,3,8,1.375,1.125
Escobedo,1,0,1,2,1.0,2.5
Cowdenbeath,66,48,137,251,1.011952,1.681275
Turris,0,0,1,1,0.0,1.0
Bemerton H,2,2,1,5,2.2,1.6
Sportfreunde L,8,3,9,20,1.2,1.45
Millbrook,2,0,1,3,2.333333,1.333333
Haughmond,1,0,4,5,1.4,3.0
BFC Daugavpils,0,0,7,7,0.142857,2.714286
Brest II,1,0,0,1,3.0,1.0
Red Star Brno,0,0,1,1,2.0,3.0
Antequera,1,0,1,2,1.5,1.5
Gyirmot FC Gyor,5,9,19,33,0.636364,1.545455
Lichfield City,1,0,2,3,1.666667,2.666667
Wigan,120,83,124,327,1.324159,1.250765
Nicaragua,13,7,18,38,1.447368,1.368421
Antalyaspor,72,58,79,209,1.229665,1.497608
Dunav Ruse,36,33,64,133,0.992481,1.511278
UCC,0,0,1,1,1.0,4.0
Spalding Utd,0,1,7,8,1.25,3.0
Reading,117,90,130,337,1.231454,1.308605
Leamington,107,74,88,269,1.401487,1.234201
Veroia,15,22,42,79,0.835443,1.556962
Parma,41,36,72,149,1.174497,1.657718
Littlehampton T,1,2,1,4,2.0,1.75
Boston Utd,109,56,91,256,1.542969,1.363281
Bahlinger SC,0,2,1,3,1.666667,2.0
Panachaiki,0,0,1,1,0.0,2.0
Ware,3,1,6,10,1.1,2.1
Guisborough T,3,1,5,9,2.222222,2.666667
Kings Langley,45,34,67,146,1.390411,1.746575
AFC Rush & D,4,3,5,12,1.5,2.0
Western United,19,6,18,43,1.651163,1.44186
Biggleswade United,4,4,4,12,2.0,1.916667
Druids,0,1,1,2,0.5,1.0
W Ham U23,4,3,3,10,1.5,1.3
Wacker Nord,0,1,1,2,0.5,2.0
Biel-Bienne,0,0,1,1,2.0,3.0
Chelmsford,112,62,88,262,1.637405,1.366412
Edgware Town,2,0,3,5,1.8,2.4
Camberley T,5,1,3,9,1.888889,1.555556
Bedfont & Feltham,1,0,2,3,1.666667,2.666667
Coria,0,0,1,1,2.0,3.0
Deportivo Galicia,0,0,1,1,1.0,2.0
TB Tvoroyri,0,2,5,7,0.142857,1.285714
Sestri Levante,0,0,1,1,0.0,4.0
Sileks,0,4,8,12,0.583333,1.916667
Jeanne d'Arc,0,0,1,1,0.0,6.0
Augsburg,70,61,108,239,1.271967,1.598326
Seattle,96,43,67,206,1.495146,1.184466
KTP Kotka,7,13,15,35,0.8,1.285714
Epernay RC,0,0,1,1,0.0,1.0
Melilla,3,0,6,9,1.111111,1.888889
Hayes & Y,55,45,69,169,1.372781,1.597633
Usti nad Labem,0,0,1,1,0.0,2.0
Linfield,159,42,57,258,2.05814,0.965116
Treaty United,2,3,0,5,1.0,0.6
Vasteras,2,0,1,3,2.333333,0.666667
Panthrakikos K,12,12,25,49,0.857143,1.591837
Welling Town,2,0,1,3,3.666667,2.666667
Stansfeld,0,1,1,2,1.0,2.5
Chesterfield,97,71,148,316,1.202532,1.484177
Tijuana,1,1,2,4,0.75,1.5
Denmark,32,22,11,65,1.876923,0.784615
San Marino,0,2,44,46,0.086957,4.043478
Evesham,6,5,5,16,1.1875,1.3125
Le Puy Foot 43,5,5,2,12,1.416667,1.083333
Tow Law Town,1,0,1,2,1.5,5.0
East Cowes Victoria Athletic,0,0,1,1,2.0,3.0
Voltigeurs de Chateaubriant,6,1,1,8,1.5,0.5
St Patrick's,83,48,84,215,1.227907,1.204651
Metz,63,54,88,205,1.092683,1.463415
Hacken,84,51,59,194,1.592784,1.103093
Kickers Off.,0,0,3,3,0.666667,3.333333
Kaisar Kyzylorda,0,1,9,10,0.6,2.5
W Brom U23,4,0,5,9,1.222222,1.555556
Chiasso,0,0,2,2,0.5,2.0
Sputnik,1,1,7,9,0.888889,2.888889
Bylis Ballsh,1,1,3,5,0.8,2.4
Southend M,0,0,1,1,1.0,4.0
Granville,0,1,0,1,2.0,2.0
Corinthian Cas,30,19,48,97,1.206186,1.597938
Al-Nassr,0,0,1,1,1.0,5.0
Metalurg Z.,3,14,21,38,0.394737,1.947368
Torino,97,84,90,271,1.557196,1.431734
Troon Juniors,0,1,1,2,1.5,2.0
Lorient,57,39,79,175,1.268571,1.514286
Debenham LC,0,1,1,2,0.5,1.5
Coventry,128,91,115,334,1.239521,1.212575
Guingamp II,0,1,0,1,1.0,1.0
Chikhura Sach.,11,8,10,29,1.068966,1.241379
Cambodia,3,2,15,20,0.6,3.05
C Leonesa,24,19,25,68,1.411765,1.617647
Viking,60,31,60,151,1.509934,1.509934
Cologne II,0,0,1,1,1.0,2.0
Caronnese,0,0,1,1,1.0,2.0
Kahramanmarasspor,0,0,1,1,1.0,3.0
Cirencester,41,21,61,123,1.349593,1.780488
Vereya Stara,24,22,59,105,0.704762,1.752381
Formentera,7,11,10,28,1.035714,1.714286
Crotone,39,27,84,150,1.133333,1.74
Barbados,5,3,11,19,1.052632,1.631579
Egham Town,2,1,7,10,1.5,2.6
FCI Levadia,1,0,2,3,2.333333,2.666667
Longford T,69,41,78,188,1.335106,1.430851
Spezia,26,18,30,74,1.297297,1.418919
Melbourne Vic,77,34,64,175,1.611429,1.457143
Lincoln,156,86,98,340,1.529412,1.176471
Hereford.,1,0,0,1,2.0,1.0
Lyon-la-Duch.,2,2,1,5,1.0,0.8
St Montois,1,0,2,3,0.666667,2.0
Kirby Muxloe,0,0,1,1,0.0,1.0
Stratford,46,42,65,153,1.379085,1.575163
Nimes,35,29,59,123,1.203252,1.634146
Renate,2,2,4,8,1.25,1.75
E Stadtallendorf,0,0,1,1,0.0,3.0
Georgia,19,18,24,61,1.213115,1.196721
Sibenik,8,8,15,31,1.0,1.290323
Hannover,73,51,104,228,1.337719,1.570175
Windsor,9,0,4,13,2.153846,2.076923
Schwaz,0,0,1,1,0.0,6.0
Xanthi,52,61,62,175,0.908571,1.057143
Beselidhja,0,0,1,1,0.0,1.0
Djibouti,2,1,10,13,0.461538,3.461538
St Brieuc,0,0,1,1,0.0,2.0
Steyning Town,4,0,3,7,2.428571,1.857143
Farsley,0,0,1,1,0.0,4.0
Huesca,89,73,91,253,1.217391,1.249012
Guinea-Bissau,7,6,11,24,0.916667,1.625
Bayonne,0,0,1,1,0.0,2.0
Sochaux,23,18,17,58,1.172414,1.0
Optik Rathenow,0,0,1,1,1.0,2.0
Oeffingen,0,0,1,1,2.0,5.0
F. Sittard,25,19,45,89,1.337079,2.067416
Chester-le-Street Town,1,0,2,3,1.0,2.0
Gornik Zabrze,63,65,70,198,1.328283,1.40404
CP Cosmos,0,0,1,1,2.0,3.0
Bremer SV,0,0,2,2,0.0,5.0
Viborg,19,16,30,65,1.061538,1.369231
Laci,4,7,9,20,0.95,1.35
Hartley Wint.,38,24,35,97,1.628866,1.556701
Tarbes,0,1,0,1,0.0,0.0
Sidmouth Town,0,0,1,1,0.0,5.0
Din. Bucharest,96,60,85,241,1.302905,1.195021
Havant & W,123,65,86,274,1.605839,1.288321
Mamelodi S,0,0,2,2,0.5,3.0
Krumkachy,14,16,32,62,0.822581,1.5
JS St Jean Beaulieu,0,0,1,1,2.0,10.0
Jamaica Women,0,0,4,4,0.75,3.75
Luch Minsk,4,12,14,30,0.8,1.466667
Worksop,4,2,5,11,1.545455,2.727273
Tanzania,8,17,18,43,0.790698,1.255814
FC Brno,35,35,62,132,0.984848,1.454545
Newry City,8,5,27,40,0.925,1.775
Teramo,1,0,4,5,1.0,2.0
St Pauli,74,55,80,209,1.277512,1.401914
Kalmar,52,50,85,187,1.064171,1.427807
Tuzla City,1,3,9,13,0.538462,1.538462
Hamrun Spar,1,2,0,3,1.333333,1.0
Greece,22,16,20,58,1.086207,1.017241
Baldock Town,1,0,5,6,1.5,3.0
Lamia,28,52,49,129,0.751938,1.232558
Chindia Targoviste,21,17,32,70,0.928571,1.285714
Tonbridge,113,62,95,270,1.503704,1.348148
Glengad United,0,0,1,1,0.0,2.0
Yenisey,0,0,2,2,1.0,3.0
Kazakhstan U21,0,0,1,1,0.0,1.0
Man City U23,3,1,1,5,2.4,1.8
Burnley,99,72,109,280,1.114286,1.285714
Alajuelense,0,0,2,2,0.0,1.0
Fleury 91,4,2,6,12,1.333333,1.25
Mariupol,42,36,59,137,1.094891,1.525547
Dundalk,155,51,52,258,1.965116,0.879845
Notts Co,115,80,129,324,1.320988,1.503086
Welton Rovers,2,1,2,5,1.4,1.8
EF Reims Sainte-Anne,0,0,1,1,0.0,1.0
Mlada Boleslav,83,59,75,217,1.543779,1.410138
Sociedad,115,73,99,287,1.473868,1.275261
Turnovo,0,0,2,2,1.0,4.0
AFC W'bledon,106,97,133,336,1.181548,1.333333
Sheerwater,0,0,2,2,0.0,3.5
Camelon Jnrs,9,1,1,11,4.0,1.545455
Freienbach,0,0,1,1,2.0,11.0
Langreo,0,1,2,3,1.666667,2.333333
Ashford (Mdx),6,6,5,17,1.705882,2.0
Boluspor,0,0,2,2,0.5,2.5
Aiglon du Lamentin,0,0,1,1,2.0,3.0
Clachnacuddin,25,19,66,110,1.354545,2.3
Portland Utd,1,0,3,4,1.0,1.75
AB Argir,0,0,3,3,0.666667,4.0
Unione Venezia,2,1,3,6,1.5,1.666667
South Africa,22,25,14,61,1.262295,0.885246
Bari,10,3,6,19,1.315789,0.947368
Las Palmas,85,82,114,281,1.19573,1.451957
Stal Mielec,4,9,13,26,1.076923,1.807692
Swansea U23,8,2,4,14,1.428571,1.142857
Sigma O.,54,48,57,159,1.226415,1.226415
Moreirense,67,59,94,220,1.068182,1.390909
Dorchester,79,57,121,257,1.36965,1.77821
Lleida Esportiu,7,7,11,25,0.8,1.2
Becerril,1,0,1,2,0.5,4.0
Kayserispor,55,59,91,205,1.063415,1.570732
SV Grodig,13,9,31,53,1.132075,1.698113
Montecatini,0,0,1,1,0.0,3.0
Epila,0,1,0,1,0.0,0.0
Ross County U20,1,0,3,4,1.25,2.5
Roma,171,76,74,321,1.844237,1.208723
Guyana,3,6,9,18,1.944444,2.277778
Fiorentina,113,81,94,288,1.5,1.302083
Gelbison,0,0,1,1,1.0,3.0
Long Eaton U,7,2,4,13,2.153846,1.846154
Mil-Mugan,0,0,1,1,0.0,7.0
Jonkopings Sodra,15,24,24,63,1.063492,1.460317
Cheshunt,20,4,28,52,1.423077,1.807692
Pelister Bitola,2,3,7,12,0.916667,2.083333
Witheridge,0,0,1,1,0.0,1.0
Georgia Rustavi,0,1,0,1,2.0,2.0
Besiktas,163,58,61,282,1.943262,1.141844
Ontinyent,1,1,3,5,1.0,1.2
Aurillac,0,0,2,2,1.5,3.5
Scotland,24,11,20,55,1.454545,1.236364
Bury Town,12,7,18,37,1.297297,1.891892
Viktoria Koln,5,2,4,11,1.636364,1.727273
NK Inter,39,49,92,180,1.0,1.805556
Zadar,5,4,8,17,1.117647,1.411765
Rabotnicki,12,9,13,34,1.588235,1.382353
NK Radomlje,3,13,36,52,0.634615,2.230769
Bologna,74,54,111,239,1.179916,1.447699
Knaphill,4,0,3,7,2.714286,2.285714
Atl Madrid B,1,0,1,2,1.0,1.5
Coggeshall T,0,2,2,4,0.5,1.25
NY Red Bulls,93,41,66,200,1.595,1.26
Downton,0,0,2,2,2.0,5.0
Apolonia Fier,0,0,1,1,1.0,2.0
Fleetwood,131,95,118,344,1.287791,1.177326
Celik Zenica,2,3,0,5,0.8,0.4
Tobol,4,6,7,17,0.764706,1.058824
Yen. Krasnoyarsk,6,8,20,34,0.941176,1.794118
Burghausen,1,0,0,1,1.0,0.0
Basaksehir,126,74,64,264,1.530303,1.125
Top Oss,0,0,1,1,0.0,2.0
Pap New Guinea,6,2,9,17,1.647059,1.823529
Young Boys,174,62,59,295,2.050847,1.20678
Concordia Basle,0,0,2,2,0.0,5.5
FC Schotz,0,0,1,1,2.0,3.0
Bodmin Town,6,0,5,11,1.454545,1.454545
Albissola,0,0,1,1,0.0,1.0
Praiense,0,0,1,1,1.0,5.0
Sparta Prague,130,56,58,244,1.754098,1.040984
Bedlington Ter.,2,0,2,4,1.75,1.75
Botev Plovdiv,76,57,89,222,1.238739,1.297297
Gimnastica Segoviana,0,1,1,2,0.5,1.0
Zaragoza,108,81,103,292,1.212329,1.167808
Buckland Ath,11,0,5,16,2.125,1.3125
Queen's Park,95,75,98,268,1.268657,1.317164
Kolos Kovalivka,23,14,25,62,1.193548,1.354839
SV Sandhausen II,0,1,0,1,1.0,1.0
Chinato,0,0,1,1,0.0,3.0
Serbia,29,18,17,64,1.578125,1.203125
FK Suduva,24,13,19,56,1.392857,1.017857
Atromitos,84,64,73,221,1.140271,1.063348
Nuremberg,75,61,83,219,1.420091,1.497717
KV Reykjavik,0,0,1,1,1.0,7.0
Bosnia U21,0,0,2,2,0.0,3.5
Boness Utd,5,4,3,12,2.083333,1.583333
La Suze,0,0,1,1,1.0,2.0
Buducnost P.,8,6,15,29,0.965517,1.310345
Irvine,0,0,1,1,1.0,2.0
Novi Pazar,35,25,62,122,0.991803,1.540984
Tskhinvali,3,3,1,7,2.428571,1.428571
S. Bratislava,49,14,20,83,2.168675,1.144578
Mutilvera,1,1,2,4,1.0,1.75
Cardiff MU,58,32,67,157,1.375796,1.312102
Honduras,20,20,25,65,1.215385,1.292308
PFC Montana,12,20,60,92,0.75,1.73913
Laval,7,14,15,36,0.916667,1.333333
NK Krsko,32,42,70,144,0.888889,1.555556
Avangard Kursk,1,0,1,2,0.5,1.0
US Rumelange,1,1,10,12,1.083333,3.0
Kapaz,2,2,10,14,0.428571,1.357143
Wolves U23,5,2,5,12,1.916667,1.583333
Fakenham Town,1,3,0,4,1.5,1.25
Jammerbugt,0,0,1,1,1.0,6.0
Godalming,0,0,2,2,0.5,3.5
Lithuania,9,9,37,55,0.618182,2.054545
Sud Nivernais Imphy-Decize Sn,0,0,1,1,1.0,3.0
Erith & Belv,2,2,4,8,1.625,2.375
Stockton T,15,0,6,21,2.285714,1.047619
Ghana,24,17,16,57,1.421053,0.894737
Whitchurch United,0,1,2,3,1.0,2.666667
Dinamo Batumi,2,4,7,13,0.384615,1.384615
Seaford Town,1,0,2,3,1.0,4.0
Ermis,0,2,10,12,0.916667,3.583333
Potters Bar,31,22,45,98,1.295918,1.438776
Huracan,0,0,1,1,1.0,2.0
Studley,0,0,1,1,1.0,4.0
Cardiff,121,81,109,311,1.286174,1.254019
Hillerod,0,0,1,1,3.0,5.0
Kaiserslautern,38,35,54,127,1.259843,1.440945
Sarreguemines,5,2,3,10,1.4,1.6
Hoffenheim II,1,1,1,3,1.0,1.0
B. 1905,62,66,73,201,1.054726,1.19403
Erzegbirge A,63,49,77,189,1.164021,1.37037
FC Ufa,52,64,82,198,0.848485,1.131313
Cigand SE,0,0,1,1,0.0,2.0
Pordenone,15,12,7,34,1.529412,1.147059
Berane,0,0,2,2,1.0,4.0
Zaragoza II,1,0,0,1,2.0,1.0
Marathon,0,1,3,4,1.0,4.5
Bekescsaba,7,9,18,34,0.794118,1.617647
Spartak Myjava,1,1,4,6,1.0,2.333333
Zvijezda,0,0,1,1,0.0,4.0
Hatayspor,15,9,12,36,1.583333,1.25
Slovakia,28,14,22,64,1.453125,1.1875
Troyes,25,21,63,109,1.045872,1.743119
Panetolikos,56,53,94,203,0.950739,1.369458
Botev Vratsa,26,20,45,91,1.142857,1.472527
Wolfsburg,120,67,87,274,1.510949,1.29562
New Mills,1,1,2,4,1.25,2.5
Slask Wroclaw,80,69,85,234,1.264957,1.273504
Qabala,28,18,29,75,1.386667,1.226667
Broadfields U,1,0,4,5,1.0,3.2
Sligo Rovers,68,56,83,207,1.154589,1.318841
Orlando City,56,55,79,190,1.378947,1.657895
L'Hospitalet,0,0,2,2,1.5,3.5
Edusport Acad,35,18,52,105,1.72381,1.895238
GAIS,1,0,2,3,1.333333,2.666667
Lip. Stiavnica,0,0,1,1,0.0,4.0
BetLanes,0,0,1,1,1.0,2.0
Petrolul Ploiesti,11,14,32,57,0.684211,1.245614
Middlesbrough U21,9,3,11,23,1.608696,1.913043
May and Baker Eastbrook C,2,0,2,4,2.75,1.25
Trepca 89,4,0,5,9,2.333333,2.0
Moulins,0,3,1,4,0.75,1.0
Chelsea U21,22,10,17,49,1.693878,1.408163
Jeunesse Esch,7,4,8,19,1.684211,1.473684
Wehen-Wiesb.,20,10,23,53,1.528302,1.660377
Columbus Crew,75,51,70,196,1.413265,1.392857
Llapi,1,0,2,3,1.333333,4.0
Italy U21,9,7,9,25,1.36,1.04
Azerbaijan,12,17,26,55,0.872727,1.418182
Sutjeska,12,10,13,35,1.028571,1.028571
St. Omer,0,1,3,4,0.75,2.75
Whittlesey Athletic,0,0,1,1,0.0,6.0
Smolevichi-STI,11,16,37,64,0.921875,1.765625
Francs Borains,0,0,1,1,0.0,3.0
Larkhall,4,2,7,13,1.384615,1.769231
Colwyn Bay,16,12,44,72,1.097222,2.152778
Kallithea,0,0,1,1,2.0,3.0
Libertas,0,0,2,2,0.0,1.5
O. Marcquois,0,0,1,1,2.0,3.0
Rosyth,0,0,1,1,3.0,5.0
Caen,60,42,93,195,1.025641,1.466667
R-Weiss Essen,5,4,4,13,1.230769,1.538462
Larissa,34,51,70,155,0.806452,1.316129
Tours,15,13,25,53,1.226415,1.377358
Zlatibor Cajetina,5,7,21,33,0.757576,1.727273
Abbey Hey,1,0,3,4,0.75,2.25
Glentoran,99,56,86,241,1.510373,1.319502
Matera,2,0,3,5,0.8,0.8
AD Union Adarve,1,2,1,4,0.5,1.25
Arezzo,3,1,5,9,1.222222,1.888889
Lothian Hutchison,0,0,1,1,1.0,4.0
Thailand,19,9,18,46,1.26087,1.26087
Ilfracombe T,0,0,1,1,0.0,4.0
Moldova U21,0,0,3,3,0.333333,3.666667
Coventry Cops,0,0,1,1,0.0,2.0
KSV Baunatal,0,0,1,1,2.0,3.0
Ballinamallard U,29,25,77,131,1.083969,1.954198
Northwich,16,8,4,28,2.392857,1.035714
Street,2,3,3,8,1.75,2.375
Cray Valley PM,10,4,6,20,2.2,1.5
Aylesbury FC,2,2,5,9,1.444444,2.222222
Doncaster,130,87,121,338,1.440828,1.275148
Ebro,6,6,7,19,1.0,1.052632
Albacete,75,67,96,238,0.983193,1.189076
FC Romania,5,2,6,13,1.538462,1.538462
Germania,0,0,1,1,0.0,3.0
Lothian Thistle,8,3,4,15,1.866667,1.866667
KI Klakksvik (DO NOT USE),2,1,1,4,2.5,1.5
Club Rapido de Bouzas,1,0,3,4,1.25,2.25
Teruel,0,0,2,2,1.0,2.5
FC Nottingen,0,0,2,2,1.5,4.0
Clapton,2,0,2,4,1.75,2.25
Togo,7,13,15,35,1.028571,1.228571
Stoke U21,6,4,14,24,1.083333,1.916667
Pays Argentonnais,0,0,1,1,0.0,8.0
Drenica Skenderaj,0,0,1,1,1.0,3.0
Greuther Furth II,1,0,0,1,2.0,1.0
Hamburg,86,56,90,232,1.349138,1.465517
Bravo Publikum,21,22,23,66,1.227273,1.30303
Kaerjeng,1,0,3,4,1.5,3.5
Dag & Red,114,66,129,309,1.275081,1.31068
Handsworth Parramore,2,0,4,6,2.666667,3.166667
Reims,57,60,65,182,1.126374,1.274725
Legia Warsaw,155,62,70,287,1.609756,0.972125
Ioannina,51,54,69,174,1.005747,1.178161
Luneville,0,0,2,2,0.5,2.0
Uni Cluj,4,6,8,18,0.5,1.277778
Albania,23,9,26,58,1.12069,1.258621
Rochdale,121,87,136,344,1.30814,1.465116
Sarpsborg,63,65,66,194,1.304124,1.35567
Prishtina,5,5,5,15,0.866667,1.066667
Charlton,121,89,125,335,1.301493,1.289552
Lusitanos,2,5,3,10,1.1,1.7
Burnley U23,1,0,1,2,2.0,2.5
Basingstoke,81,41,92,214,1.630841,1.593458
Saprissa,1,3,4,8,0.75,2.25
Gubbio,1,1,1,3,1.333333,1.333333
Zorya,96,55,71,222,1.463964,1.126126
O. Ljubljana,133,63,52,248,1.729839,0.931452
La Chataigneraie,0,1,0,1,1.0,1.0
Chasetown,5,2,6,13,1.615385,1.692308
U S Portsmouth,4,1,1,6,2.0,1.5
Greuther Furth,76,59,76,211,1.327014,1.398104
Garstang,0,1,1,2,1.5,3.5
Leeds U21,0,1,2,3,0.666667,4.0
Ukraine U-21,0,0,1,1,0.0,2.0
Arlesey,5,5,14,24,0.958333,1.875
Clevedon T,4,0,2,6,2.5,1.5
Belarus,21,13,28,62,0.967742,1.467742
Guia,0,0,1,1,0.0,1.0
Inter,160,69,72,301,1.727575,1.026578
Jamaica,23,9,24,56,1.142857,1.285714
HIFK Helsinki,42,48,60,150,1.2,1.353333
FC Slutsk,53,42,86,181,0.944751,1.342541
Feurs,0,1,0,1,0.0,0.0
Farsley AFC,81,34,44,159,1.830189,1.371069
Histon,20,18,42,80,1.35,2.0125
Levadiakos,37,36,67,140,0.842857,1.307143
Austria U21,5,5,3,13,1.076923,1.153846
M. Petah Tikva,67,51,68,186,1.043011,1.102151
Azal,0,0,9,9,0.111111,2.222222
Oravska Poruba,0,0,1,1,0.0,7.0
Don Benito,0,0,1,1,0.0,1.0
Isloch Minsk,58,37,62,157,1.140127,1.343949
Spartaks Jurmala,11,10,12,33,1.545455,1.30303
Oleiros,0,0,1,1,2.0,4.0
Pollok,0,0,1,1,1.0,2.0
Lech Poznan,119,66,82,267,1.490637,1.052434
Niort,9,7,23,39,1.051282,1.717949
Leiknir Reykjavik,0,0,2,2,0.0,1.0
Degerfors,0,0,3,3,0.666667,2.0
Bryne,0,0,1,1,2.0,6.0
Fermana,0,2,1,3,1.333333,1.666667
Stade Poitevin,0,1,0,1,1.0,1.0
Mongolia,4,1,13,18,1.166667,2.666667
Brescia,18,15,34,67,1.149254,1.641791
Super Nova,0,0,1,1,0.0,6.0
Sevilla Atletico,20,25,39,84,1.0,1.380952
S Dniprodzerzhynsk (do not use,3,5,4,12,1.0,1.583333
Wells City,0,1,2,3,1.0,2.0
Monaco,160,71,84,315,1.784127,1.279365
Bristol R,129,79,128,336,1.33631,1.285714
Lazio,165,61,91,317,1.782334,1.26183
Mons Calpe,1,2,2,5,1.0,2.4
Volyn,16,18,37,71,0.957746,1.56338
Kolkheti Poti,0,3,4,7,0.571429,1.714286
Umraniyespor,2,0,0,2,1.0,0.0
IF Fuglafjordur,0,1,6,7,0.428571,2.428571
US Granvillaise,8,3,7,18,1.5,1.388889
Como,1,1,5,7,0.714286,1.857143
Iskra-Stal Ribnita,0,0,1,1,1.0,9.0
Kyzyl-Zhar,0,0,2,2,0.5,3.0
Babte,0,0,2,2,0.0,3.0
Schweinfurt,4,1,5,10,1.3,2.0
Alresford Town,2,0,2,4,2.0,2.0
Raunds Town,0,0,1,1,0.0,1.0
Bad Gleichenberg,0,0,1,1,0.0,3.0
Giana Erminio,1,1,3,5,0.6,1.8
Reims II,1,2,1,4,1.5,1.0
Ourense,0,0,1,1,0.0,1.0
Wurzburger FV,0,0,1,1,0.0,2.0
Barwell,72,42,65,179,1.50838,1.418994
Chile,32,18,25,75,1.493333,1.2
San Nicolo,1,1,0,2,1.5,1.0
Macau,2,1,4,7,1.0,2.285714
AFC Bridgnorth,2,0,2,4,1.25,1.5
Mariehamn,65,51,73,189,1.137566,1.349206
Whitton Utd,0,0,3,3,1.333333,3.333333
BKV Elore,0,0,1,1,1.0,3.0
Borac Cacak,35,24,68,127,0.968504,1.464567
Czech Rep,30,8,26,64,1.546875,1.28125
Vikingur (Ice),2,3,5,10,1.1,2.0
QPR,102,73,142,317,1.230284,1.473186
Aruba,2,0,5,7,0.714286,2.571429
Atvidabergs,2,9,19,30,0.833333,1.833333
Royal W Bassett T,2,0,2,4,2.25,1.5
Donji Srem,2,4,9,15,0.8,1.266667
Motagua,0,2,2,4,0.5,1.5
Hapoel Ash,11,20,36,67,0.701493,1.432836
Kaunas,0,0,1,1,0.0,3.0
Sint Maarten,0,0,1,1,0.0,12.0
Babite,0,0,1,1,1.0,2.0
Airdrieonians,103,43,105,251,1.418327,1.438247
Tvaakers IF,1,0,2,3,1.333333,2.0
Biggleswade T,65,39,71,175,1.542857,1.525714
Edinburgh C,94,47,81,222,1.396396,1.310811
Uruguay,32,11,21,64,1.625,1.046875
St Johnstone,110,66,105,281,1.217082,1.245552
Manchester United Gibraltar,0,0,2,2,0.0,5.5
Rayners Lane,1,0,0,1,3.0,2.0
ESM Gonfreville,0,1,2,3,0.333333,1.666667
Espanyol,109,75,108,292,1.229452,1.280822
Galatasaray,137,57,65,259,1.833977,1.138996
Tambov,12,8,39,59,0.915254,1.677966
Podbrezova,2,1,7,10,0.6,1.7
B Dortmund,179,65,71,315,2.142857,1.215873
Gosk Gabela,0,0,3,3,0.333333,2.0
Sliema W.,2,1,2,5,1.8,1.6
Bangor City,57,17,40,114,1.614035,1.473684
AC Houilles,0,0,1,1,0.0,3.0
Hanley Town,1,0,5,6,0.666667,2.333333
Triestina,4,1,3,8,1.875,2.0
KAS Eupen,50,44,89,183,1.234973,1.857923
Riteriai,2,2,2,6,1.333333,1.833333
Beckenham T,3,3,4,10,2.7,2.6
Olympiakos Nic.,1,1,1,3,1.0,2.333333
Italy Women,6,1,2,9,2.111111,0.888889
Bhutan,3,0,11,14,0.642857,5.0
Trelissac,3,4,4,11,1.181818,1.272727
PAOK Salonika,156,68,63,287,1.616725,0.89547
Adanaspor,6,7,21,34,0.970588,1.823529
Dominican Rep,4,1,7,12,1.416667,1.416667
Lancaster,51,43,52,146,1.390411,1.465753
Croydon,3,0,4,7,1.714286,2.857143
Heracles,81,46,89,216,1.467593,1.625
Pt Talbot,14,11,21,46,1.326087,1.978261
FC Mika,1,0,2,3,1.333333,2.0
SC Weiche Flensburg 08,1,0,1,2,1.0,2.5
FC Groningen,75,62,84,221,1.298643,1.38009
AOX Kissamikos,0,1,0,1,1.0,1.0
Dijon,62,52,104,218,1.206422,1.577982
P Bielsko-Biala,19,25,38,82,1.109756,1.804878
N'castle U21,10,5,19,34,1.529412,2.058824
Anstey Nomads,4,1,1,6,1.333333,0.666667
Osasuna II,0,1,0,1,0.0,0.0
London Bari,0,0,1,1,1.0,2.0
Bregalnica S,1,1,0,2,4.5,2.5
Anderlecht,132,74,82,288,1.538194,1.177083
Partick,93,62,112,267,1.220974,1.340824
Newport P T,10,0,5,15,2.2,2.066667
Brentwood T,17,17,35,69,1.42029,1.826087
Casarano,1,0,1,2,1.5,2.0
Armthorpe Welf,0,0,1,1,0.0,8.0
Royston,42,11,24,77,1.987013,1.311688
Romania U21,7,4,2,13,2.0,1.076923
Toluca,0,0,2,2,0.0,2.5
Scarborough A,35,18,36,89,1.438202,1.449438
Ravensburg,0,0,1,1,0.0,2.0
PSV Eindhoven,167,51,44,262,2.209924,1.038168
Halmstads,11,18,36,65,0.815385,1.430769
Montagnarde,2,2,3,7,1.428571,1.428571
Altay Izmir,0,0,1,1,1.0,2.0
Terbuni Puke,0,0,3,3,0.0,3.333333
Barrow,120,88,104,312,1.387821,1.246795
Siracusa,0,0,1,1,1.0,3.0
Brackley,128,84,75,287,1.550523,1.04878
Jagiellonia,108,52,81,241,1.46888,1.327801
FC Elmstead,0,0,1,1,0.0,2.0
Blue Boys Mulenbach,0,0,1,1,1.0,3.0
Stoke,94,88,118,300,1.133333,1.36
Alanyaspor,69,34,71,174,1.534483,1.413793
FC Neftochimik,8,7,18,33,1.030303,1.545455
Leon,1,1,2,4,1.0,1.5
Hafnarfjordur,17,15,11,43,1.209302,1.069767
Ayr,117,59,98,274,1.605839,1.310219
SS Virtus,0,0,3,3,0.666667,2.666667
Cabinteely,54,33,84,171,1.116959,1.608187
Taunton Town,55,26,26,107,1.990654,1.495327
IC Croix Football,8,3,4,15,1.533333,1.2
Bournem'th FC,1,0,4,5,2.0,2.2
1860 Munich,24,19,40,83,1.048193,1.349398
San Sebastian,1,0,2,3,1.0,1.666667
Leixoes,1,0,1,2,1.5,3.0
Concarneau,6,5,4,15,1.333333,0.933333
Atl Madrid,199,89,59,347,1.585014,0.723343
Kazakhstan,11,14,26,51,0.960784,1.54902
Kimberley M W,1,0,2,3,0.333333,2.0
Loko Gorna,7,9,16,32,1.0,1.59375
Slavia Karlovy Vary,0,0,1,1,3.0,10.0
Mallorca,86,64,92,242,1.103306,1.123967
SV Rodinghausen,1,2,1,4,2.0,2.0
Nice II,0,0,1,1,0.0,3.0
Glenavon,110,61,71,242,1.834711,1.553719
Almeria,96,83,108,287,1.195122,1.1777
New Milton Town,1,1,2,4,0.75,2.0
Admira Wacker,66,56,103,225,1.151111,1.72
At Sanluqueno,1,0,1,2,0.5,0.5
Wadham Lodge,1,0,1,2,1.0,2.0
Leyton Orient,120,77,129,326,1.288344,1.340491
Dukla Pribram,40,35,95,170,0.976471,1.888235
Weston S-M.,80,44,117,241,1.522822,1.817427
BSC Hastedt,0,0,1,1,1.0,11.0
Burnham R,0,0,1,1,0.0,1.0
Shelbourne,80,36,59,175,1.485714,1.142857
Real Salt Lake,68,43,74,185,1.378378,1.52973
Shepton Mallet,0,0,2,2,2.0,5.0
Kapfenberg,0,0,1,1,1.0,2.0
Samoa,2,0,4,6,1.0,3.666667
Longridge Town,4,2,3,9,2.444444,1.777778
Espanyol B,0,1,0,1,2.0,2.0
Dundonald Bluebell,0,1,3,4,1.5,4.0
Chartres,1,1,1,3,1.666667,1.0
Birmingham,95,94,130,319,1.065831,1.344828
Seregno,0,1,1,2,0.0,1.5
Grays,43,26,62,131,1.259542,1.755725
Comillas,0,1,1,2,0.5,3.0
B M'gladbach,124,58,90,272,1.713235,1.349265
Moldova,5,16,40,61,0.442623,1.852459
Blanc Mesnil,0,0,1,1,0.0,2.0
Kilmarnock,96,68,115,279,1.215054,1.333333
Blois,0,0,2,2,0.5,2.0
Barnoldswick,1,0,2,3,2.0,2.333333
Troyes II,0,1,0,1,1.0,1.0
NK Split,18,31,41,90,0.666667,1.2
FK Raca,0,0,1,1,0.0,9.0
Le Havre,13,11,9,33,1.515152,1.393939
Rincon,1,0,1,2,1.0,1.5
Viby,0,0,1,1,0.0,3.0
P-sur-Moselle,0,0,2,2,0.5,2.5
Metalurg S.,0,0,2,2,0.5,2.0
Zemplin Michalovce,1,1,10,12,0.75,2.333333
Kaposvar,4,2,27,33,0.818182,2.424242
Slavia Prague,153,61,47,261,1.877395,0.835249
Guichen,0,0,2,2,0.5,1.5
Berre,0,0,1,1,1.0,2.0
Spartak Moscow,106,45,66,217,1.488479,1.207373
Dinaz Vyshhorod,0,1,0,1,0.0,0.0
Kerkyra,19,23,37,79,0.810127,1.417722
Folkestone,88,38,64,190,1.868421,1.484211
Lille,126,64,91,281,1.338078,1.103203
Dinamo-Auto,2,2,9,13,0.692308,2.307692
Arminia,71,76,67,214,1.383178,1.345794
Sanjoanense,0,0,1,1,0.0,4.0
VfB Lubeck,0,1,2,3,1.333333,2.666667
Atletico Porcuna,0,0,1,1,0.0,2.0
Rodez,2,3,5,10,0.6,1.1
Quorn,6,0,6,12,2.25,2.166667
Enfield Borough,1,0,2,3,2.666667,4.0
Snodland Town,0,0,1,1,1.0,5.0
Genoa,77,67,116,260,1.211538,1.503846
Odd Grenland,91,43,64,198,1.505051,1.338384
Vikingur Gota,15,4,9,28,1.714286,1.357143
FK Krasnodar,120,68,68,256,1.601562,1.054688
Leganes,97,73,108,278,1.061151,1.154676
Girona,115,79,94,288,1.246528,1.121528
FC Andorra,1,2,1,4,1.0,0.75
Sheff Utd U23,1,1,1,3,1.333333,2.333333
FC Zimbru,1,2,8,11,0.818182,2.090909
Little Oakley,0,1,0,1,2.0,2.0
Radnik Bijeljina,3,1,8,12,0.666667,1.5
Dudley Sports,1,1,0,2,1.5,1.0
Hampton & R,117,69,80,266,1.612782,1.255639
Vizela,0,0,1,1,1.0,2.0
Royal Antwerp,72,38,49,159,1.471698,1.358491
Mezokovesd SE,55,44,64,163,1.190184,1.349693
Trabzonspor,111,63,70,244,1.54918,1.290984
Zebbug Rangers,0,0,1,1,1.0,3.0
Milton United,0,1,0,1,2.0,2.0
Camelon Juniors,0,0,1,1,1.0,2.0
Glenafton Ath,3,0,1,4,1.75,0.5
Zaglebie Lubin,86,59,73,218,1.431193,1.233945
Desp. Aves,24,15,63,102,0.931373,1.647059
Decic Tuzi,0,1,4,5,0.0,1.8
Deveronvale,41,11,59,111,1.666667,2.099099
Metalurg R.,0,0,2,2,1.0,4.5
Tottenham,187,75,88,350,1.917143,1.102857
Dereham Town,1,1,6,8,1.25,2.75
Olimpik Donetsk,46,52,90,188,1.037234,1.56383
Travnik,0,0,1,1,0.0,1.0
Mouscron-P,62,53,119,234,1.175214,1.641026
IFK Goth'burg,80,58,61,199,1.482412,1.231156
Shoreham,0,0,3,3,1.333333,4.0
Gainsborough,84,49,110,243,1.316872,1.596708
Caudal,2,0,1,3,1.333333,1.666667
Volvic C.S,0,0,1,1,0.0,1.0
Vozdovac,82,50,94,226,1.150442,1.274336
Lochee Utd,1,1,1,3,1.666667,1.333333
Zhetysu,1,0,5,6,0.666667,1.666667
Algeciras CF,1,0,1,2,1.0,1.0
Forest Green,143,85,104,332,1.433735,1.198795
Saint-Meziery,0,0,1,1,0.0,5.0
Heston R,0,0,1,1,0.0,6.0
Romania,24,20,17,61,1.442623,1.147541
Westfields,9,4,6,19,2.473684,1.894737
Frimley Green,0,0,2,2,0.0,2.0
Radford,3,0,3,6,2.333333,2.166667
Bacup Borough,0,0,1,1,0.0,1.0
Alessandria,16,5,8,29,1.482759,1.206897
Halstead Town,0,1,0,1,3.0,3.0
Ireland,19,25,19,63,0.984127,0.968254
Shifnal T,0,0,2,2,0.5,5.0
Kecskemeti,4,4,5,13,0.923077,1.384615
Vitosha Bistritsa,12,17,64,93,0.623656,1.784946
Orsha,0,0,1,1,1.0,4.0
EB Streymur,0,0,7,7,0.857143,3.714286
Estoril,39,30,59,128,1.070312,1.484375
Flamengo,1,0,1,2,1.5,1.0
Maidenhead,116,64,112,292,1.482877,1.40411
Vlasim,0,1,0,1,1.0,1.0
Wimborne T,30,17,45,92,1.413043,1.815217
BAK 07,0,0,1,1,1.0,3.0
Torpedo Kutaisi,13,0,10,23,1.73913,1.434783
Vicenza,9,4,9,22,1.681818,1.681818
Gonsenheim,0,0,1,1,0.0,3.0
Lingfield,0,0,1,1,3.0,5.0
Helston Athletic,0,1,3,4,1.0,2.75
FC Lusitans,2,2,6,10,1.0,1.8
Netherlands,33,12,17,62,1.951613,1.080645
NK Vitez,1,0,2,3,0.333333,1.333333
Stoke U23,2,2,8,12,0.916667,1.583333
Honved,86,56,79,221,1.357466,1.257919
Roda JC,23,29,51,103,1.0,1.708738
Widnes,0,0,3,3,1.0,2.333333
Utenis Utena,2,1,4,7,0.714286,1.714286
Redhill,1,0,2,3,1.666667,2.333333
Atletico Nacional,0,1,1,2,1.0,2.5
CSMS Iasi,80,64,103,247,1.02834,1.295547
Kensington B,1,0,2,3,0.666667,2.0
Slavia Mozyr,44,38,74,156,1.153846,1.602564
Great Wakering,2,1,6,9,1.111111,2.111111
Spain,44,18,7,69,2.391304,0.724638
Grenada,2,2,8,12,0.75,2.666667
Hong Kong,9,9,5,23,1.347826,0.695652
Ossett Town,1,2,4,7,1.142857,1.428571
Navalcarnero,3,2,3,8,1.0,1.75
Burgos,1,0,3,4,1.25,1.75
Poblense,0,0,2,2,1.0,3.0
Grbalj,1,0,2,3,0.666667,1.333333
Chadderton,0,0,4,4,0.5,3.5
Black Country Rangers,0,1,2,3,3.0,4.666667
USSA Vertou,0,0,1,1,1.0,3.0
Lye Town,4,1,2,7,3.285714,1.571429
Energetyk-BDU,20,16,30,66,1.530303,1.787879
Dynamo Kiev,162,56,51,269,1.847584,0.907063
Vasas,33,20,49,102,1.215686,1.598039
Tranmere,151,81,109,341,1.422287,1.243402
Lesotho,4,10,6,20,0.65,1.1
CA Bastia,5,4,6,15,0.8,1.2
Budafoki,7,6,17,30,1.066667,1.966667
Peebles Rovers,0,0,1,1,1.0,3.0
Opava,21,23,53,97,0.845361,1.680412
East Preston,0,0,1,1,0.0,4.0
Frattese,0,0,1,1,0.0,1.0
Lombard-Papa,1,2,10,13,0.461538,2.153846
Partizan Tirana,8,16,15,39,0.897436,1.153846
AFC Mansfield,8,4,7,19,1.526316,1.421053
W. Innsbruck,9,5,19,33,1.0,1.545455
Pro Vercelli,4,1,6,11,1.363636,1.909091
Neustrelitz,0,0,1,1,0.0,2.0
Brann,68,41,48,157,1.388535,1.216561
Terrassa,0,0,1,1,2.0,4.0
M. Netanya,60,49,79,188,1.170213,1.361702
Shkendija,38,13,19,70,1.785714,1.085714
Stirling,90,53,110,253,1.316206,1.454545
Ungheni,0,0,3,3,0.0,4.333333
De Graafschap,13,13,42,68,1.132353,2.073529
Cricklewood Wanderers,1,0,3,4,0.5,3.0
Tuffley Rovers,1,0,2,3,1.666667,2.0
FK Mladost Doboj Kakanj,1,0,3,4,0.5,2.25
Sedan,7,3,4,14,1.571429,0.785714
Goztepe,47,35,55,137,1.328467,1.379562
Cremonese,11,10,9,30,1.266667,1.166667
Atletico Pantoja,0,0,4,4,0.25,2.75
Chieri,0,0,1,1,1.0,2.0
Rot-Weiss Erfurt,1,0,2,3,0.666667,1.333333
Dinan-Lehon FC,0,0,2,2,0.0,2.0
Bluebell Utd,1,0,3,4,0.75,1.5
Pinxton,3,0,3,6,2.333333,3.166667
Massese,0,0,1,1,0.0,1.0
Alashkert,21,10,15,46,1.413043,1.26087
Palestine,10,10,13,33,1.636364,1.242424
Aarhus,77,57,69,203,1.438424,1.330049
Man Utd U21,11,7,6,24,1.458333,1.375
V de S Brigida,0,0,1,1,2.0,4.0
Z Bydgoszcz,8,5,5,18,1.444444,1.166667
FC Utd,93,57,100,250,1.572,1.652
Juventus U23,0,0,1,1,0.0,1.0
Arsenal U23,2,0,2,4,1.5,2.0
Carpi,18,21,28,67,1.134328,1.507463
Malmesbury Victoria,1,0,2,3,2.0,3.333333
Cittadella,20,15,9,44,1.727273,1.045455
Sherwood Col,2,0,3,5,2.4,2.2
Bedworth Utd,15,9,32,56,1.285714,2.232143
Newcastle,97,65,118,280,1.260714,1.375
1874 Northwich,10,1,5,16,2.0625,1.25
Shildon,9,1,6,16,2.0625,1.75
Hungerford,99,54,105,258,1.321705,1.395349
Iraq Olympic,0,3,0,3,0.333333,0.333333
Wick Academy,46,28,46,120,1.925,1.733333
Stirling Univ,42,22,53,117,1.461538,1.769231
Atalanta,139,80,76,295,1.80678,1.227119
Somalia,1,0,5,6,0.5,2.166667
Cardiff U23,0,1,0,1,1.0,1.0
Targu Mures,29,27,40,96,0.958333,1.229167
China,24,16,20,60,1.6,1.066667
Independiente La Chorrera,2,1,1,4,1.75,1.25
Wantage Town,4,0,6,10,2.1,2.7
Newquay,0,0,1,1,0.0,6.0
Cobh,69,32,72,173,1.196532,1.433526
Vysocina Jihlava,27,25,53,105,1.009524,1.6
Cheltenham,135,86,116,337,1.382789,1.246291
Wisbech Town,4,1,6,11,1.363636,1.454545
CD Tudelano,2,1,3,6,0.666667,1.333333
Aalborg,80,57,83,220,1.295455,1.313636
Clacton,4,1,4,9,1.888889,2.444444
AE Paphos,1,0,4,5,0.8,4.2
Ch'morets N.,0,0,1,1,0.0,1.0
Liffre,0,0,1,1,1.0,4.0
Strommen,0,0,1,1,0.0,2.0
Bilbao Athletic,8,8,26,42,0.833333,1.404762
FC Lahti,60,70,56,186,1.193548,1.215054
Scunthorpe,120,88,129,337,1.299703,1.367953
Rudar Velenje,55,49,97,201,1.19403,1.666667
Slimbridge,1,1,6,8,0.875,1.625
Cliftonville,119,47,80,246,1.658537,1.296748
Belper Town,5,9,16,30,1.266667,1.7
Sierra Leone,5,1,4,10,1.0,1.3
Valletta,20,15,19,54,1.240741,1.425926
Barnstaple T,2,0,6,8,1.5,2.25
Ebbsfleet,129,80,78,287,1.543554,1.15331
Alianza,1,1,2,4,1.0,1.5
Wednesfield,0,0,2,2,0.5,4.5
St Gallen,84,44,105,233,1.420601,1.690987
Sabah FK,0,2,5,7,0.142857,1.571429
Barnet,105,77,130,312,1.230769,1.442308
Backa Topola,32,16,18,66,1.924242,1.30303
Leicester,138,70,95,303,1.577558,1.214521
Campodarsego,0,1,1,2,2.0,2.5
H. Kopavogs,0,0,1,1,1.0,2.0
Comunicaciones,0,2,0,2,1.0,1.0
UAE,22,11,16,49,1.571429,1.020408
West Bridgford,1,0,1,2,2.0,2.0
Bitton,6,0,3,9,2.777778,1.333333
Zimbabwe,9,9,7,25,1.24,0.88
Zabudova-2007,0,0,2,2,0.0,7.5
Okzhetpes,0,2,9,11,0.545455,2.0
Talavera CF,4,2,3,9,1.333333,1.0
Portimonense,37,31,64,132,1.212121,1.55303
Chinese Taipei,4,0,14,18,1.0,3.0
Binfield,4,5,1,10,2.4,1.6
Crystal Palace,97,55,120,272,1.180147,1.389706
Watford U21,2,0,0,2,2.0,1.0
Ural Sver. Oblast,56,61,75,192,1.083333,1.442708
Houston,51,46,71,168,1.434524,1.517857
Croatia,37,17,17,71,1.746479,1.084507
Badalona,4,4,5,13,1.230769,1.153846
Intercity S J d'Alacant,1,0,1,2,1.5,1.5
Wales Women,1,0,0,1,1.0,0.0
SS Reyes,0,1,0,1,1.0,1.0
Virtus Entella,8,6,11,25,1.0,1.32
V N Novgorod,2,0,1,3,1.0,1.0
West Brom,99,86,105,290,1.282759,1.344828
Tabor Sezana,23,13,29,65,1.215385,1.369231
Fiji,6,8,10,24,1.5,1.25
Norrkoping,110,44,43,197,1.80203,1.147208
Buckingham T,0,0,1,1,4.0,5.0
Uxbridge,4,0,6,10,1.6,1.9
Stamford,30,22,42,94,1.5,1.744681
FC Schaffhausen,0,0,3,3,0.666667,2.333333
Marseille,134,81,86,301,1.574751,1.229236
Sabadell,12,28,25,65,0.830769,1.215385
Workington,108,37,84,229,1.537118,1.349345
FC Magdeburg,18,16,22,56,1.178571,1.410714
Southall,10,1,6,17,2.647059,1.882353
Stourport,6,0,3,9,2.444444,1.777778
Desborough T,4,0,3,7,3.857143,2.714286
Hurlford,0,0,1,1,0.0,5.0
Tuttocuoio,1,0,2,3,1.0,2.0
Palmeiras,0,1,1,2,0.0,0.5
Piast Gliwice,98,62,79,239,1.32636,1.192469
Schiltigheim,1,0,3,4,1.25,3.5
Pyunik Yerevan,18,8,12,38,1.473684,1.605263
Sp. Rotterdam,35,27,64,126,1.277778,1.825397
B93 Copenhagen,0,0,1,1,0.0,3.0
Caernarfon,33,17,37,87,1.37931,1.712644
Rubin,66,63,71,200,1.0,1.055
Ponsacco,0,0,1,1,1.0,4.0
H. Kfar Saba,32,34,64,130,0.738462,1.230769
Holwell Sports,0,0,1,1,0.0,2.0
Flint Town U,8,1,18,27,1.074074,2.037037
Newi CD,47,41,75,163,1.208589,1.687117
Woking,117,73,121,311,1.424437,1.44373
Wegberg-Beeck,0,0,2,2,1.0,2.5
Condal Club,0,0,1,1,2.0,8.0
Juventus,237,56,50,343,1.912536,0.801749
Macon,0,1,0,1,0.0,0.0
Nuneaton Griff,5,1,2,8,2.0,1.875
Strasbourg,64,47,68,179,1.357542,1.402235
Biggleswade,3,4,4,11,1.454545,1.454545
Rizespor,54,52,84,190,1.257895,1.557895
Vitesse Arn.,106,57,74,237,1.7173,1.257384
PS Kemi,24,19,56,99,0.979798,1.676768
Stutt. Kickers,0,1,1,2,2.0,3.5
Lviv,20,22,44,86,0.825581,1.674419
Brackley Town Saints,0,0,1,1,2.0,4.0
Irtysh,6,5,8,19,0.947368,1.263158
Cova Piedade,0,0,1,1,0.0,4.0
Andorra CF,0,0,1,1,0.0,5.0
Gil Vicente,24,19,42,85,0.988235,1.447059
Steaua,148,69,62,279,1.609319,0.956989
Merthyr,84,62,78,224,1.633929,1.464286
San Roque,0,2,0,2,1.5,1.5
Deinze,1,0,0,1,2.0,0.0
Glossop,8,5,7,20,1.6,1.4
Ex Maassluis,0,0,1,1,0.0,4.0
Tilbury,5,2,6,13,2.384615,2.307692
Hall Road Rangers,3,0,1,4,2.75,2.25
Vardar Skopje,25,12,16,53,1.641509,1.339623
Siena,1,1,3,5,0.6,1.8
Strathspey T,22,6,72,100,1.12,3.05
Estonia,18,17,35,70,0.914286,1.628571
Pagham,3,0,4,7,2.0,2.857143
Tarxien Rainbows,1,0,4,5,0.6,2.4
Virgin Isl. (UK),0,1,4,5,0.4,2.6
Real Betis,107,71,101,279,1.333333,1.408602
Slavoj Vysehrad,0,0,1,1,0.0,8.0
Ascoli,7,6,12,25,1.48,2.04
Coleshill,13,2,7,22,2.5,2.590909
Faroe Islands,10,10,27,47,0.765957,1.93617
Feronikeli,7,1,4,12,1.916667,1.083333
Indonesia,8,5,11,24,1.375,1.583333
Muret,0,0,1,1,0.0,2.0
Threave Rovers,0,0,6,6,0.333333,3.666667
Thailand Women,0,0,7,7,0.428571,5.142857
Lyon II,2,0,0,2,2.5,1.0
Clermont,16,8,14,38,1.5,1.210526
Serbia U21,7,5,9,21,0.857143,1.333333
Tajikistan,7,3,11,21,1.333333,1.714286
Blackburn U21,7,2,1,10,2.5,1.1
Alania Vlad.,0,0,1,1,1.0,3.0
Newport (IOW),6,1,6,13,2.461538,1.769231
Gennevilliers,0,0,1,1,0.0,2.0
Blackpool,115,104,120,339,1.244838,1.238938
Deeping R,6,0,3,9,2.444444,1.777778
Ordabasy,9,7,14,30,1.166667,1.466667
Livingston U20,0,1,2,3,0.666667,2.333333
Stanway,6,2,4,12,1.416667,1.833333
Mjallby,16,10,10,36,1.611111,1.333333
Akzhayik,0,0,3,3,0.666667,3.0
Devizes Town,0,0,1,1,0.0,3.0
Lynx,0,0,4,4,0.5,3.25
Aveley,12,4,9,25,1.88,1.6
Atlanta U,70,26,45,141,1.723404,1.198582
Wroxham,6,1,4,11,2.454545,1.818182
Eynesbury Rovers,3,0,4,7,2.857143,2.571429
Billericay,120,71,87,278,1.780576,1.442446
Cibao FC,0,0,2,2,0.0,3.5
Tynecastle BC,0,1,1,2,0.0,4.0
Balikesirspor,3,7,9,19,1.684211,2.0
Zakarpatty,5,11,22,38,0.763158,1.973684
Litex,14,15,6,35,1.314286,0.971429
Croatia Women,0,1,1,2,1.0,1.5
Aldershot,106,76,119,301,1.219269,1.362126
Portugal Olympic,2,1,1,4,1.25,1.5
Zaqatala,0,1,0,1,2.0,2.0
Lower Breck,3,0,3,6,2.0,2.166667
Ipswich W,4,1,3,8,1.625,1.375
Zirka,16,17,31,64,0.796875,1.296875
Broadbridge H,1,0,1,2,2.5,4.0
Oberneuland,0,0,2,2,0.5,7.0
Atlantas,1,4,14,19,0.684211,2.210526
Fuenlabrada,37,41,22,100,1.18,0.97
Holland FC,0,0,1,1,1.0,2.0
St Ives,28,21,55,104,1.163462,1.932692
Turks & Caicos,0,0,6,6,0.666667,7.166667
Marbella,4,1,4,9,1.222222,1.333333
Hitchin,84,45,51,180,1.644444,1.244444
Hemel,94,74,95,263,1.528517,1.574144
New England,64,54,71,189,1.402116,1.566138
Tottenham U23,2,0,2,4,1.5,1.25
SV Elversberg,4,5,3,12,2.0,1.666667
Middlesbrough,134,80,112,326,1.211656,1.055215
TuS Erndtebruck,0,0,3,3,1.0,4.333333
Ferrol,2,1,4,7,0.857143,1.428571
Sutton Cold.,43,28,78,149,1.154362,1.832215
French Guiana,6,1,4,11,1.727273,1.636364
Granit Mikashev,17,16,27,60,0.85,1.633333
Lucchese,0,1,2,3,1.0,2.333333
Keshla,1,1,1,3,1.0,1.666667
Fortuna Singelik,0,0,1,1,0.0,11.0
Uzbekistan,25,6,22,53,1.339623,1.075472
Modena,2,2,6,10,1.1,1.5
Bala Town,101,45,63,209,1.732057,1.38756
Tooting & M,16,9,33,58,1.275862,2.034483
Sumqayit,3,3,15,21,0.666667,1.857143
Bochum,84,63,67,214,1.5,1.327103
Maidstone,112,68,110,290,1.310345,1.372414
Three Bridges,3,0,7,10,1.1,2.3
Makedonia,0,0,1,1,2.0,3.0
Avellino,3,2,6,11,1.272727,1.636364
Ormiston,0,0,1,1,1.0,2.0
Real Union,0,3,2,5,0.8,1.2
Sevenoaks T,3,2,4,9,1.777778,2.111111
Nostell M W,0,0,1,1,0.0,2.0
Viktoria Plzen,155,48,54,257,1.735409,0.992218
Lok. Moscow,106,60,64,230,1.356522,1.047826
Pacos Ferreira,58,50,80,188,1.069149,1.414894
New Zealand Women,4,0,6,10,0.7,1.4
Southend U CC,0,0,1,1,2.0,3.0
Glebe,4,1,3,8,1.875,2.0
TSV Havelse,0,0,1,1,1.0,5.0
Sintra,0,1,0,1,1.0,1.0
Trikala,0,1,0,1,0.0,0.0
Zamudio,0,0,1,1,0.0,4.0
Szombathelyi H,48,31,66,145,1.096552,1.468966
Alton Town,0,0,3,3,0.666667,3.0
Limerick,62,33,74,169,1.431953,1.710059
Jedinstvo,0,0,2,2,1.5,5.0
Zamora,2,0,3,5,1.4,2.0
La Fiorita,12,1,15,28,1.178571,1.785714
Everton U23,9,2,2,13,2.076923,0.615385
Koper,40,34,49,123,1.154472,1.390244
Brimscombe & Thrupp,5,3,4,12,1.583333,1.916667
Bordeaux II,0,0,1,1,0.0,3.0
Viktoria Asch.,0,0,1,1,1.0,2.0
Vejle BK,14,18,26,58,1.103448,1.568966
Newton Aycliffe,5,0,3,8,2.75,1.75
Torpoint Ath,3,0,4,7,1.285714,1.428571
Rad Beograd,63,46,119,228,0.885965,1.464912
Dila,6,1,6,13,1.307692,1.230769
Sheff Utd,140,72,106,318,1.421384,1.176101
Senica,1,0,11,12,0.666667,3.0
IR Reykjavik,0,1,0,1,1.0,1.0
Pirmasens,0,0,3,3,0.666667,2.666667
KS Luftetari,1,3,3,7,1.0,2.142857
AFC Stoneham,0,0,2,2,1.0,2.5
Stalybridge,72,51,127,250,1.236,1.756
Olhanense,0,0,1,1,0.0,1.0
Sauchie,1,2,3,6,2.0,2.666667
Colombia,32,20,15,67,1.402985,0.910448
Cheadle Town,0,0,2,2,0.5,3.5
PSV II,0,0,1,1,1.0,2.0
IB Keflavik,0,0,3,3,0.333333,3.0
St Blazey,0,1,0,1,2.0,2.0
Sporting Khalsa,13,3,7,23,2.130435,1.608696
Armenia U21,0,1,0,1,0.0,0.0
Whickham,0,0,2,2,0.5,3.5
Bognor Regis,117,63,85,265,1.683019,1.275472
JS Saint-Pierroise,1,0,1,2,1.0,1.0
Levante,94,70,108,272,1.257353,1.433824
Romsey Town,0,0,3,3,1.666667,3.0
Mboro U23,2,2,6,10,0.9,1.6
France U21,7,5,4,16,1.375,1.125
Wealdstone,119,69,98,286,1.604895,1.531469
Marine,78,63,94,235,1.391489,1.459574
Scotland U21,0,0,4,4,0.0,2.25
Trelleborgs,3,6,22,31,0.774194,2.16129
Konyaspor,78,80,82,240,1.133333,1.2125
Salford,148,75,73,296,1.635135,1.070946
Toronto FC,90,53,64,207,1.714976,1.400966
Pulpileno,0,0,1,1,1.0,2.0
Trakia Plovdiv,0,1,0,1,1.0,1.0
Bottesford Town,3,1,3,7,3.0,2.285714
Crediton United,0,0,1,1,1.0,3.0
Fidelis And.,0,1,0,1,1.0,1.0
Burton,121,80,123,324,1.243827,1.358025
Tsarsko Selo,17,11,28,56,0.928571,1.375
Nacional,36,36,80,152,1.026316,1.756579
Cerceda,0,0,1,1,0.0,1.0
Chatham Town,3,2,6,11,1.363636,2.181818
AthlÃ©tico Marseille,0,1,0,1,0.0,0.0
East Kilbride,92,28,35,155,2.135484,1.006452
Anaitasuna,1,0,1,2,1.5,1.0
Bamber Br.,27,18,49,94,1.425532,1.808511
Rutherglen G,0,0,1,1,1.0,4.0
Kamza,0,1,1,2,1.0,1.5
Brandon United,0,0,1,1,0.0,8.0
Romford,3,0,5,8,1.25,2.125
Crowborough,6,1,4,11,2.454545,1.909091
Senegal,37,15,10,62,1.516129,0.629032
Toulon,0,1,0,1,1.0,1.0
Elgin City,109,43,109,261,1.651341,1.586207
Exmouth Town,6,0,4,10,2.4,1.9
Beith Juniors,10,2,2,14,2.857143,1.214286
Puskas FA FC,63,45,69,177,1.271186,1.378531
Hucknall,3,0,4,7,2.428571,2.285714
Mexico Women,0,0,4,4,0.25,2.5
Manchester 62,0,1,1,2,0.0,1.5
Dunkirk,2,0,3,5,1.8,2.4
Vendee Les Herbiers,15,13,12,40,1.275,1.125
Hinchesti,0,1,1,2,1.0,1.5
Albion,69,50,125,244,1.245902,1.79918
Market Drayton,0,0,5,5,0.4,2.2
RKC Waalwijk,11,11,35,57,1.0,1.877193
Wisbech St Mary,1,0,1,2,1.5,2.5
Fylde,143,77,75,295,1.877966,1.271186
Lechia Gdansk,97,62,73,232,1.37069,1.228448
Waregem,88,56,105,249,1.62249,1.783133
Welwyn Gard C,7,2,5,14,2.0,1.785714
Dunajska Streda,10,3,8,21,1.857143,1.857143
Nancy,31,16,38,85,1.070588,1.235294
Mornar,1,0,0,1,1.0,0.0
Zalgiris Vilnius,17,10,9,36,1.472222,0.972222
Micronesia,0,0,2,2,0.0,38.0
P Niedercorn,21,5,18,44,1.704545,1.340909
Milton Keynes Robins,1,0,1,2,1.5,3.0
Torpedo Mosc.,3,6,5,14,1.0,1.285714
Shakhtar,180,47,43,270,2.166667,0.988889
Ringwood Town,0,0,1,1,1.0,3.0
Barry Town,57,21,42,120,1.408333,1.366667
Mladost Lucani,88,58,84,230,1.156522,1.3
Coventry Sph,2,2,2,6,3.5,2.333333
Boulogne,9,11,7,27,1.481481,1.222222
CSKA Sofia,109,55,39,203,1.551724,0.704433
USA Women,13,1,0,14,3.642857,0.571429
Dnipro-1,21,9,24,54,1.425926,1.481481
Horsham,25,9,20,54,1.537037,1.333333
Luxembourg U21,0,0,1,1,1.0,4.0
St Pryve-St Hilaire,5,2,2,9,1.444444,1.0
Arda,20,20,15,55,1.163636,1.109091
Frickley,40,24,58,122,1.254098,1.598361
Doxa,0,4,8,12,0.416667,2.083333
Eibar,78,68,118,264,1.166667,1.435606
Oskarshamns AIK ,1,0,2,3,1.333333,2.666667
SC Paderborn,59,45,79,183,1.437158,1.650273
Wrexham,120,87,103,310,1.248387,1.112903
Lebanon,9,6,9,24,1.125,0.875
Belgium Women,1,0,1,2,3.0,3.5
Mali Women,0,0,2,2,1.0,3.0
Mile Oak,0,0,1,1,1.0,2.0
Jordan,21,13,17,51,1.490196,0.980392
D'fermline U20,0,0,1,1,1.0,4.0
Marlow,7,2,7,16,1.75,2.3125
Shrivenham,0,0,1,1,2.0,3.0
Saint-Quentin,0,1,1,2,0.5,1.0
Cockhill C,0,0,3,3,0.333333,1.666667
Central Coast M,34,31,102,167,1.161677,2.077844
The New Saints,155,40,40,235,2.561702,0.914894
England Women,9,1,5,15,1.6,0.866667
Warminster Town,3,0,1,4,2.25,1.75
England,45,14,13,72,2.027778,0.736111
Minai,4,6,14,24,0.666667,1.791667
Pontedera,0,1,4,5,0.8,1.8
Spartak Nalchik,0,0,1,1,2.0,5.0
Ashton Utd,109,62,90,261,1.59387,1.524904
Oman,15,5,13,33,1.393939,1.333333
Neftchi Baku,11,8,15,34,1.294118,1.558824
Sportfreunde D,0,0,1,1,0.0,5.0
Poland U21,7,4,7,18,1.5,1.388889
Western Sydney,56,50,67,173,1.473988,1.595376
Swansea U21,11,5,15,31,1.225806,1.548387
Kenya,17,11,13,41,0.97561,0.902439
Ards,30,21,65,116,1.163793,1.844828
Lida,0,0,2,2,1.0,3.0
Billingham T,3,0,4,7,2.142857,2.142857
Northampton S,0,0,1,1,1.0,5.0
Colliers Wood U,1,0,3,4,1.5,3.0
Gyori ETO,4,3,6,13,1.230769,1.769231
Union Mertert,0,0,1,1,0.0,2.0
Leatherhead,112,49,93,254,1.46063,1.389764
Sherborne Town,0,0,2,2,0.5,3.5
Rennes TA,1,0,1,2,0.5,1.5
Pafos,1,1,2,4,1.0,1.5
Bastia,39,30,47,116,1.025862,1.327586
Fulham,117,81,116,314,1.353503,1.394904
Ukraine Women,0,0,1,1,1.0,5.0
Miedz Legnica,10,10,18,38,1.078947,1.763158
Haugesund,74,49,69,192,1.40625,1.380208
Paris,10,12,14,36,0.75,1.333333
Hertha Berlin,82,61,97,240,1.3125,1.470833
Kadakas,0,0,1,1,0.0,8.0
Plymouth,142,73,122,337,1.35905,1.326409
Deportiva Ceuta,0,0,1,1,0.0,3.0
AltoVicentino,0,0,2,2,0.5,2.0
Olympique d'Ales,4,0,3,7,2.0,1.0
S Karagandy,2,1,5,8,0.875,2.0
Villarreal,151,88,97,336,1.497024,1.133929
FC Tiraspol,1,0,0,1,3.0,1.0
Herfolge,0,1,0,1,2.0,2.0
Schalding-Heining,0,0,1,1,1.0,3.0
Dundee U20,0,2,4,6,1.5,2.5
Brighton,108,85,102,295,1.19661,1.186441
Andover Town,1,0,3,4,1.25,2.25
Panama,25,22,38,85,0.929412,1.364706
Liberia,8,3,11,22,0.954545,1.227273
Cadiz,94,77,66,237,1.139241,0.953586
Andratx,0,0,1,1,0.0,3.0
Oxford,156,95,112,363,1.550964,1.176309
Greenhouse Sports,1,0,1,2,2.0,1.5
Belenenses,62,77,92,231,0.935065,1.393939
Montenegro U21,0,0,4,4,0.25,3.25
Folgore Falciano,1,3,12,16,0.5625,1.625
Silkeborg,27,28,59,114,1.219298,1.815789
Loko Skopje,0,0,1,1,1.0,4.0
AIK Solna,115,56,44,215,1.525581,0.883721
Goole,0,1,6,7,1.285714,4.857143
Rohrbach,0,0,1,1,0.0,4.0
Wisla Krakow,78,60,92,230,1.452174,1.413043
Framlingham T,1,0,1,2,1.5,1.0
Beroe Stara,95,59,65,219,1.269406,1.027397
Homburg,2,0,2,4,0.75,1.25
Yeclano,2,0,3,5,1.6,1.8
Pau,4,9,5,18,0.833333,1.222222
AFC Hayes,0,1,1,2,1.5,2.5
Academico Viseu,0,1,1,2,0.5,2.0
Libourne S-S,0,0,1,1,0.0,2.0
Ankaran Hrvatini,5,11,20,36,0.916667,2.333333
Quevilly,10,8,7,25,1.68,1.16
Dinamo Minsk,119,48,53,220,1.445455,0.863636
Napoli,194,63,73,330,1.933333,1.057576
Long Buckby,1,0,1,2,2.0,2.0
Nyiregyhaza,4,4,6,14,1.142857,1.642857
Real Esteli,0,0,2,2,0.0,2.5
Dunbar U,0,0,2,2,0.5,2.5
Tamworth,62,37,61,160,1.5,1.5875
Colegios Diocesanos,0,0,1,1,0.0,3.0
Torquay,116,65,119,300,1.403333,1.356667
Maltby Main,2,0,2,4,2.75,2.5
HOB Hawthorn,1,0,2,3,1.666667,2.333333
S Walden T,2,1,4,7,2.714286,2.571429
Rigas FS,3,0,5,8,1.25,1.625
Manisaspor,0,0,1,1,0.0,9.0
Italy,40,18,10,68,1.897059,0.720588
Smorgon,1,1,6,8,0.5,2.375
Sweden Women,9,1,3,13,1.461538,0.615385
Racing Rioja,1,0,1,2,1.5,1.0
Broxburn,0,0,1,1,1.0,2.0
Belgium U21,5,1,5,11,2.0,1.636364
Viterbese,2,1,2,5,1.2,0.8
Newcastle University,0,0,1,1,1.0,3.0
NEC Nijmegen,22,14,32,68,1.014706,1.5
Hemsworth Miners Welfare,3,0,5,8,1.375,2.75
Schalke,98,69,102,269,1.301115,1.460967
Arcos,0,0,1,1,0.0,2.0
Burkina Faso,15,14,14,43,1.232558,1.139535
Barcelona,263,63,48,374,2.542781,0.90107
AFC Portchester,1,0,3,4,1.25,2.0
Oedt,0,0,1,1,0.0,6.0
Melilla CD,1,0,1,2,1.0,2.5
Olsa Brakel,0,0,1,1,1.0,6.0
Erzurum B,16,21,32,69,1.043478,1.463768
Numancia,76,90,84,250,1.128,1.188
Reading U21,8,4,5,17,2.176471,2.235294
Gibraltar Utd,0,0,1,1,0.0,2.0
Swindon Sup.,42,18,34,94,1.585106,1.489362
Parnu,0,1,1,2,0.5,1.5
Leicester U23,3,4,10,17,1.058824,2.058824
Pena Sport,1,0,3,4,1.5,1.5
Feyenoord,133,53,62,248,1.935484,1.173387
Ampthill Town,0,2,2,4,0.75,1.25
Inter Club D'Escaldes,1,0,2,3,1.0,1.333333
Glasgow Univ,0,0,2,2,1.0,5.5
Curzon A,81,73,101,255,1.282353,1.45098
Picerno,0,0,1,1,0.0,2.0
Tiverton,63,29,45,137,1.912409,1.59854
Vestsjaelland,5,4,7,16,0.9375,1.3125
Waltham Forest,1,1,2,4,1.75,1.75
Borec,0,1,0,1,1.0,1.0
Dordrecht,3,4,10,17,0.705882,2.0
Mulhouse,0,0,2,2,1.5,3.0
Honduras Olympic,2,1,3,6,1.333333,2.333333
Petrocub,3,1,8,12,0.75,1.5
Ashington,2,0,3,5,2.2,2.2
Catanzaro,2,2,2,6,1.5,1.333333
SV Morlautern,0,0,1,1,0.0,5.0
FC Haka,5,7,10,22,1.136364,1.863636
Barrow Town,0,0,2,2,0.5,1.5
W Casablanca,0,0,2,2,1.0,2.0
Harborough T,1,0,2,3,2.0,4.0
Cadiz II,0,1,0,1,0.0,0.0
Osasuna,104,81,93,278,1.154676,1.244604
Wingate & F,98,50,116,264,1.405303,1.643939
Urraca,0,0,1,1,0.0,1.0
Bulgaria,15,11,27,53,0.90566,1.603774
Bassano V,2,3,3,8,1.125,1.625
Mexico,59,23,19,101,1.653465,1.009901
Virgin Isl. (US),1,0,6,7,0.142857,4.0
Erciyesspor,3,4,12,19,1.315789,2.263158
Cibalia,10,17,45,72,0.861111,2.138889
Durango,1,0,2,3,1.666667,1.333333
Mickleover S,77,48,104,229,1.30131,1.502183
St Vin & Gren,3,3,9,15,1.466667,3.466667
Toledo,3,1,3,7,2.0,1.428571
Vendsyssel,6,11,15,32,1.0,1.53125
Speranta Nisporeni,1,0,10,11,0.363636,2.636364
Redbridge,3,1,3,7,1.285714,2.285714
Villarreal B,1,2,1,4,0.75,1.0
Guadeloupe,0,0,4,4,0.0,2.5
Sheppey United,4,1,4,9,1.777778,1.888889
G. Torrelavega,0,1,2,3,0.333333,2.0
Santos Laguna,5,0,1,6,3.333333,1.5
Balzan,8,4,16,28,1.392857,1.928571
Stade Brest,32,28,36,96,1.260417,1.364583
Dnyapro,9,6,19,34,1.029412,1.5
Harrogate (old),0,0,1,1,1.0,2.0
FV Illertissen,0,1,0,1,0.0,0.0
Lens,35,29,41,105,1.180952,1.409524
Sandecja N S,6,15,16,37,0.918919,1.459459
Puerto Rico,2,4,9,15,0.733333,2.0
Melbourne C,80,33,62,175,1.737143,1.377143
Rochdale Town,0,0,1,1,2.0,4.0
Rende,0,0,4,4,0.25,1.75
Corsham Town,0,0,1,1,0.0,1.0
Cen Af Rep,1,2,1,4,1.5,2.0
Ebreichsdorf,0,1,1,2,0.0,2.5
Bustleholme,0,0,1,1,1.0,4.0
Kashima Antlers,3,1,3,7,1.857143,2.142857
Metta Riga,0,1,10,11,0.363636,2.454545
Covilha,1,1,1,3,1.0,1.0
El Salvador,15,14,25,54,0.814815,1.388889
Westside,0,0,1,1,3.0,4.0
Dartford,123,66,81,270,1.581481,1.277778
Victoria Wand,0,0,1,1,1.0,3.0
Jeunesse Canach,0,1,3,4,1.0,2.5
Costa Rica,27,20,30,77,1.077922,1.12987
Sireti,0,0,2,2,0.0,13.5
Istres,0,0,2,2,0.5,2.0
Badajoz,4,4,4,12,0.916667,1.0
Chipstead,4,5,6,15,1.4,1.666667
Botswana,3,5,14,22,0.590909,1.227273
Margate,83,63,107,253,1.252964,1.494071
Levski Sofia,112,55,63,230,1.513043,0.865217
F Dusseldorf II,2,0,0,2,2.0,0.0
Newcastle B,7,2,6,15,2.066667,1.666667
Mali,14,19,15,48,1.166667,1.104167
Loko. Sofia,6,5,2,13,1.076923,0.615385
Glenville,0,0,1,1,0.0,1.0
Anzhi,28,29,69,126,0.849206,1.587302
NK Istra 1961,41,60,126,227,0.801762,1.634361
Matelica,0,0,3,3,0.0,1.333333
Haverhill Borough,0,0,2,2,1.5,4.0
Uruguay Women,0,0,1,1,1.0,3.0
Frosinone,26,24,60,110,1.027273,1.681818
Izarra,0,0,1,1,2.0,6.0
Rusthall,0,0,3,3,1.0,3.666667
Mamurrasi,0,0,2,2,0.5,8.5
Angels FC,0,0,1,1,1.0,13.0
Backa Palanka,32,26,86,144,0.847222,1.604167
Rukh Brest,17,16,9,42,1.833333,1.142857
Russia U21,1,0,5,6,1.666667,2.5
St Mochtas,0,0,1,1,2.0,3.0
King's Lynn,104,58,86,248,1.495968,1.391129
Hobro IK,35,43,71,149,1.053691,1.604027
Bristol C U23,2,0,0,2,2.5,1.0
Daring Echternach,0,0,1,1,1.0,6.0
NKF Burbage,2,0,1,3,2.0,1.333333
Forfar,92,54,117,263,1.34981,1.562738
Sfintul Gheorghe,0,2,3,5,0.2,2.0
Mattersburg,54,40,80,174,1.206897,1.695402
China Women,2,2,4,8,0.625,1.125
Loures,0,0,1,1,1.0,2.0
All Dudelange,1,0,0,1,4.0,0.0
Lillestrom,45,46,63,154,1.311688,1.545455
Faversham,2,0,7,9,1.444444,2.0
Mauritania,10,6,14,30,1.033333,1.466667
Sarre Union,2,1,6,9,1.0,2.0
Enfield T,119,58,86,263,1.745247,1.361217
Hackney Wick,0,0,1,1,0.0,7.0
FK Pobeda,3,0,2,5,1.2,1.6
Chile Women,1,2,5,8,0.5,2.25
USV Eschen-M,0,0,1,1,1.0,5.0
Cracovia,87,66,83,236,1.360169,1.25
Portmore United,0,0,2,2,0.5,3.0
Deportivo B,1,1,0,2,0.5,0.0
Sepsi Sfantu G,42,51,54,147,1.122449,1.210884
R Volgograd,4,6,17,27,0.444444,1.814815
Nigeria Women,4,2,4,10,2.4,1.0
Hyde,53,39,79,171,1.385965,1.631579
Colchester,108,90,129,327,1.272171,1.406728
Kortrijk,90,51,100,241,1.423237,1.46888
Hradec Kralove,12,5,27,44,0.977273,1.704545
Crumlin U,2,0,1,3,2.0,1.666667
Montanesa,0,0,1,1,0.0,1.0
Tromso,45,32,73,150,1.3,1.673333
Le Portel,0,0,1,1,1.0,4.0
Fisher,1,1,2,4,1.5,1.25
Oleksandria,66,59,67,192,1.21875,1.229167
Mulbarton Wanderers,3,1,0,4,2.5,0.0
Sevilla,202,75,97,374,1.695187,1.157754
Riom,0,0,1,1,0.0,1.0
Arenas Club,0,0,2,2,0.5,2.0
Guam,3,2,12,17,0.705882,2.294118
Oldham,104,98,133,335,1.247761,1.41791
Armenia,19,10,23,52,1.538462,1.730769
Hajvalia,0,0,1,1,0.0,3.0
Naxxar Lions,0,0,1,1,0.0,4.0
Valmiera,0,2,3,5,0.6,2.0
Carrarese,1,1,5,7,0.857143,1.857143
Angers SCO II,0,1,0,1,1.0,1.0
Pickering Town,6,5,6,17,1.352941,1.823529
Skalica,0,0,2,2,0.5,2.5
Kidlington,7,4,5,16,2.3125,2.0
AC London,0,1,1,2,2.5,3.0
Norway,26,12,20,58,1.465517,1.155172
Jablonec,97,60,63,220,1.540909,1.122727
Saxan,1,1,10,12,0.916667,2.666667
Latte Dolce,0,0,1,1,1.0,2.0
Niger,7,4,12,23,0.913043,1.130435
Messina,1,0,1,2,1.5,1.0
Southampton,104,72,114,290,1.255172,1.362069
Slavia Sofia,81,47,88,216,1.157407,1.305556
Charlton U21,0,0,1,1,0.0,3.0
M-BSI Jajce,0,1,0,1,0.0,0.0
Man Utd,209,82,78,369,1.710027,0.910569
Faroe Isl U21,0,0,1,1,0.0,3.0
Logrones,21,20,25,66,0.863636,1.136364
Liechtenstein,5,8,38,51,0.45098,2.72549
Spartans,74,21,40,135,1.985185,1.251852
DAC,1,1,2,4,0.75,1.25
BFC Preussen,0,0,1,1,0.0,7.0
Saarbrucken,22,4,6,32,2.09375,0.90625
Santa Clara,32,25,42,99,1.151515,1.222222
Avondale,0,0,1,1,0.0,2.0
Gernika,1,0,1,2,0.5,0.5
Al Ain,0,2,1,3,2.0,3.0
Runcorn,5,2,5,12,2.166667,2.0
Saumur,3,3,3,9,1.333333,1.222222
Diss Town,0,0,1,1,2.0,3.0
Cray W,29,13,14,56,2.125,1.464286
Ingolstadt II,1,0,1,2,2.0,1.0
Gresley Rovers,2,1,6,9,1.0,1.888889
Portsmouth,171,80,100,351,1.552707,1.088319
Tottenham U21,6,8,21,35,1.514286,2.171429
Met. Police,104,58,96,258,1.527132,1.550388
Gazisehir,24,25,19,68,1.470588,1.352941
Quintanar del Rey,0,0,1,1,1.0,2.0
Wodson Park,1,0,1,2,1.0,1.0
N Ireland U-21,0,0,1,1,0.0,2.0
FC Sion,79,59,102,240,1.379167,1.504167
Lutterworth T,3,1,2,6,2.833333,2.166667
Drochtersen/A,0,0,3,3,0.0,2.333333
DC United,65,50,72,187,1.342246,1.465241
Derry City,81,51,81,213,1.333333,1.319249
Auchinleck,24,7,5,36,2.5,0.972222
Sogndal,16,20,25,61,1.180328,1.42623
Raon L Etape,0,1,2,3,1.0,2.0
Peacehaven & T,6,1,18,25,1.04,2.4
Dallas,79,54,55,188,1.446809,1.276596
Yemen,3,6,16,25,0.56,1.88
Internacional de Madrid,0,2,1,3,1.0,2.0
AFC Darwen,0,0,1,1,2.0,3.0
Ciliverghe,0,0,1,1,0.0,3.0
Bahrain,13,11,15,39,0.974359,1.0
PK-35,4,7,22,33,0.969697,1.969697
FeralpiSalo,6,1,6,13,1.384615,1.230769
Aubervilliers,0,1,0,1,2.0,2.0
Midtjylland,153,53,63,269,1.825279,1.122677
Boreham W,109,100,105,314,1.254777,1.16242
Abbey Rangers,6,1,5,12,2.0,2.0
Cayman Islands,0,2,3,5,0.2,3.8
Haringey B,48,20,39,107,1.588785,1.401869
Keith,29,15,68,112,1.616071,2.473214
Karpaty Lvov,37,53,70,160,1.0375,1.44375
Lecce,20,11,30,61,1.409836,2.0
Haskovo,2,2,9,13,0.538462,2.538462
Gretna 2008,30,14,63,107,1.392523,2.308411
St Lucia,1,0,2,3,1.666667,2.333333
Hull,123,77,128,328,1.362805,1.402439
FC Minsk,59,51,72,182,1.208791,1.32967
Levadia Tallinn,12,4,7,23,2.043478,1.173913
Brazil Olympic,3,3,0,6,2.166667,0.166667
Avro,2,0,1,3,1.666667,1.666667
Punjab United,0,0,1,1,0.0,3.0
Oberhausen,0,0,1,1,0.0,6.0
Leicester Road,0,0,2,2,3.0,4.5
Lushnja,0,0,1,1,1.0,4.0
Pontellas,0,0,1,1,0.0,1.0
H. Haifa,68,71,85,224,1.169643,1.334821
Israel U21,0,1,0,1,0.0,0.0
FC Bolsover,0,0,1,1,1.0,3.0
Arles-Avignon,0,1,2,3,0.333333,2.0
Cook Islands,2,0,1,3,1.333333,0.666667
Zenit,149,55,53,257,1.856031,0.918288
Gomel,31,28,64,123,0.95935,1.300813
GFC Ajaccio,22,22,29,73,1.136986,1.356164
Boston Town,0,0,1,1,2.0,3.0
Cardassar,0,1,1,2,0.0,1.5
Barking,5,3,7,15,1.066667,1.733333
Stromsgodset,68,51,70,189,1.555556,1.560847
G. Segoviana,2,0,3,5,0.8,1.2
Rebecq,0,0,1,1,0.0,3.0
Villarrubia,0,1,0,1,0.0,0.0
Cadbury Heath,4,0,4,8,3.625,4.125
Napredak,68,44,77,189,1.195767,1.280423
Niger Women,0,0,1,1,0.0,15.0
AFC Eskilstuna,10,17,38,65,0.923077,1.8
Portugalete,2,0,3,5,0.8,1.4
Northampton,125,87,127,339,1.336283,1.368732
Eastbourne U,1,0,1,2,1.0,0.5
FK Rad 1923,3,3,9,15,0.733333,1.333333
CD Boiro,0,0,1,1,1.0,5.0
Ash Utd,0,0,1,1,0.0,4.0
Belarus U21,0,1,3,4,0.75,2.5
Pedroneras,0,0,1,1,1.0,2.0
Sutton Utd,137,86,90,313,1.428115,1.134185
Fraga,0,0,1,1,0.0,1.0
Canning Town,0,0,1,1,5.0,7.0
S'derland U23,6,3,2,11,1.545455,1.181818
Famalicao,21,22,22,65,1.323077,1.476923
Banants,1,0,14,15,0.466667,2.4
Haverfordwest,14,12,33,59,1.016949,1.779661
Ramsgate,2,2,7,11,1.090909,2.818182
Trinidad,12,15,30,57,1.035088,1.807018
Saint-Lo,0,1,1,2,1.5,2.0
Adriese,0,0,1,1,0.0,1.0
Tenerife,95,102,91,288,1.149306,1.076389
Newcastle U23,3,2,2,7,1.428571,1.428571
Dunarea Calarasi,7,16,17,40,0.6,1.075
Ullensaker / Kisa,0,0,1,1,1.0,2.0
Codru Lozova,0,0,1,1,0.0,2.0
Khazar,0,1,2,3,0.333333,1.0
Kryliya Sovetov,32,29,62,123,0.910569,1.300813
AS P-l-Mezieres,4,2,4,10,1.3,1.0
Wellingboro T,6,0,3,9,1.777778,2.111111
Portsmouth U21,0,1,0,1,0.0,0.0
Rainworth M,1,0,1,2,1.5,1.5
FC Volendam,0,1,0,1,1.0,1.0
Tonga,0,0,5,5,0.2,3.4
Whitstable,4,2,5,11,1.545455,1.545455
SV Linx,0,0,1,1,1.0,2.0
AEK Larnaca,42,20,18,80,1.4875,0.9875
Cribbs,6,1,4,11,2.363636,1.727273
VPS Vaasa,48,51,66,165,1.109091,1.321212
Gorodeya,45,51,55,151,1.092715,1.218543
Sandhurst T,0,0,2,2,1.5,6.0
Marino,0,0,2,2,0.5,1.5
Heerenveen,72,62,86,220,1.540909,1.7
Mozambique,8,5,8,21,1.047619,1.238095
Philippines,9,8,17,34,1.147059,1.735294
St Joseph's,6,6,10,22,1.181818,1.590909
Thame Utd,10,3,6,19,2.157895,1.789474
Zlin,57,43,92,192,1.020833,1.46875
Waterford,79,32,83,194,1.335052,1.417526
Wattenscheid,0,0,2,2,1.0,2.5
Mladost Velika,0,0,1,1,0.0,4.0
Wales U21,0,0,1,1,0.0,2.0
CSKA 1948 Sofia,9,8,8,25,1.32,1.2
A Villa U23,2,1,2,5,1.4,1.6
Regensburg,48,44,51,143,1.433566,1.538462
Austria Lustenau,0,0,2,2,0.0,3.0
Reutlingen,3,2,3,8,2.0,1.625
M. Haifa,109,59,74,242,1.433884,1.061983
Molesey,4,0,4,8,1.875,2.0
Switzerland,36,14,16,66,1.848485,0.939394
Brora Rangers,98,14,29,141,2.836879,0.886525
A Villa U21,7,0,10,17,1.764706,2.235294
Finn Harps,74,39,86,199,1.100503,1.376884
Brantham Ath,0,0,2,2,0.0,2.5
E Frankfurt,115,65,93,273,1.534799,1.410256
Lincoln R I,27,5,14,46,2.76087,1.065217
Stafford,53,58,79,190,1.252632,1.489474
Cullompton R,2,1,3,6,1.333333,1.666667
Besa Peje,0,0,1,1,1.0,2.0
Keciorengucu,0,0,1,1,1.0,2.0
Timor-Leste,3,2,8,13,0.769231,3.769231
Bermuda,10,2,12,24,1.958333,1.666667
Hajduk Split,125,58,72,255,1.588235,1.047059
Nyonnais,0,0,1,1,0.0,1.0
Yaxley,5,2,7,14,1.714286,2.0
PFC Septemvri Sofia,21,11,35,67,0.985075,1.686567
Sp. Gijon,101,78,101,280,1.125,1.139286
Rylands,3,3,1,7,1.285714,0.571429
Eastbourne T,10,0,7,17,3.0,2.294118
CO Avallonnais,0,0,1,1,0.0,2.0
Fareham Town,3,0,3,6,2.333333,2.5
Floriana FC,5,4,8,17,1.117647,1.411765
UE Santa,1,2,9,12,0.916667,2.25
Bayreuth,0,0,1,1,1.0,6.0
El Ejido,0,0,2,2,0.0,2.5
Stockport,137,82,83,302,1.539735,1.15894
Bate Borisov,159,47,42,248,1.879032,0.927419
Darlington,108,54,77,239,1.719665,1.376569
Clay Cross Town,2,0,1,3,2.333333,1.666667
Sporting,183,54,60,297,1.818182,0.946128
Nottm Forest,108,84,129,321,1.193146,1.292835
Hounslow United,0,0,2,2,1.0,3.5
Thornbury Town,1,0,1,2,2.5,2.5
Arandina,1,0,1,2,5.0,3.0
Winterton R,2,0,2,4,1.25,2.0
Catania,4,1,5,10,1.5,1.2
Vale of Leith,1,0,0,1,1.0,0.0
Galway FC,56,49,80,185,1.351351,1.491892
Droitwich Spa,1,0,1,2,1.5,1.0
Fasano,0,0,1,1,2.0,4.0
Hallescher,4,6,5,15,1.4,1.733333
Sydney FC,101,40,32,173,1.884393,0.971098
C Zeiss Jena,5,2,8,15,1.2,1.666667
Bordeaux,106,76,101,283,1.265018,1.240283
Bradford PA,83,60,112,255,1.27451,1.615686
Maldon & T,32,3,8,43,2.860465,1.27907
Amstetten,0,0,1,1,0.0,3.0
Merani-91 Tbilisi,0,1,0,1,1.0,1.0
Ilkeston,36,25,65,126,1.039683,1.642857
Part. Bardejov,0,0,2,2,1.0,5.0
Fairford Town,1,0,3,4,1.0,2.25
Hungary,25,13,23,61,1.344262,1.262295
Monopoli,3,2,3,8,1.375,1.5
Kardemir,18,14,55,87,0.954023,2.045977
Slovenia,20,16,20,56,1.214286,0.875
G'houghton W,0,0,2,2,1.0,3.5
Wiltz,1,1,1,3,1.666667,2.0
Debrecen,73,49,70,192,1.473958,1.317708
Reading U23,6,4,8,18,1.611111,1.944444
Volgar Gaz. Ast,0,0,3,3,0.0,2.333333
St Martin,0,0,1,1,0.0,13.0
Spal,36,31,71,138,1.021739,1.608696
Malmo,139,56,45,240,1.904167,0.966667
UNA Strassen,1,1,2,4,1.25,2.5
Trapani,10,4,9,23,1.608696,1.478261
Alcoyano,8,3,4,15,1.266667,0.933333
Holland U21,1,3,1,5,1.8,1.4
Olympiakos,199,49,54,302,1.986755,0.784768
Dudley Town,1,0,1,2,2.0,1.5
Newark Flowserve,4,1,1,6,2.333333,1.833333
Varbergs Bois,11,9,15,35,1.485714,1.542857
Merida,1,0,0,1,2.0,1.0
Jelgava,14,7,10,31,1.290323,1.129032
Alfreton,76,62,114,252,1.404762,1.757937
Coggeshall United,1,0,2,3,1.0,2.0
Malaysia,7,5,16,28,1.107143,2.285714
Biesheim,2,1,0,3,2.0,1.0
Selston,0,0,1,1,0.0,3.0
Vauxhall M,5,1,2,8,2.125,1.0
Yzeure,2,0,2,4,2.0,2.25
Kletsk,0,1,0,1,2.0,2.0
O-H Leuven,21,20,33,74,1.459459,1.756757
Carrick Rangers,36,36,112,184,0.978261,1.945652
Kilmarnock U20,0,0,5,5,1.0,3.2
Tigres,13,2,6,21,1.952381,1.0
Arsenal Kiev,7,5,20,32,0.8125,1.75
El Palmar,1,0,1,2,1.5,1.5
Zalgiris,1,1,2,4,1.25,1.75
Olimpic Sarajevo,0,2,1,3,0.666667,1.333333
Juve Stabia,6,2,5,13,1.461538,1.307692
Zug,0,0,1,1,0.0,1.0
Durham City,0,0,1,1,0.0,1.0
Newport Co,120,94,135,349,1.148997,1.277937
ESA Linas Montlhery,0,0,1,1,0.0,6.0
Tooting Bec,0,0,1,1,2.0,3.0
Ethnikos Akhna,0,1,4,5,0.8,2.4
NK Aluminij,54,43,76,173,1.190751,1.456647
Rigas Futbola Skola,1,0,2,3,1.0,1.666667
Holbeach,5,0,6,11,1.727273,2.181818
Harlow,52,27,77,156,1.429487,1.942308
At Cirbonero,0,2,1,3,0.666667,1.333333
Ramsbottom,21,26,49,96,1.3125,2.072917
Babelsberg,0,0,1,1,0.0,4.0
Sampdoria,93,56,113,262,1.358779,1.496183
Atherstone T,4,3,3,10,2.6,1.4
Domzale,113,66,72,251,1.685259,1.175299
Kosovo,16,9,20,45,1.355556,1.466667
Lyon Duchere II,0,1,0,1,0.0,0.0
Villefranche,3,4,4,11,1.181818,1.181818
Islavale,0,0,1,1,1.0,2.0
Am Samoa,2,0,2,4,1.5,2.5
St Mirren U20,5,1,4,10,1.4,1.9
Kilwinning Rang,0,1,1,2,0.5,1.5
Deportivo,63,88,88,239,1.117155,1.460251
Tunisia,28,18,16,62,1.451613,0.951613
Bovey Tracey,1,0,1,2,2.5,4.0
Shanghai Sh,0,0,1,1,0.0,3.0
Cape Verde Is.,8,5,11,24,0.833333,1.083333
Djurgaardens,94,41,55,190,1.621053,1.105263
Whitby,88,58,103,249,1.361446,1.53012
Kings Lynn (old),0,1,0,1,3.0,3.0
W Beveren,56,55,124,235,1.212766,1.893617
Tarpeda,0,0,1,1,1.0,8.0
Shamrock R,124,48,56,228,1.609649,0.907895
Trastevere,0,0,2,2,0.5,3.0
Chichester C,17,4,11,32,1.75,1.46875
Cordoba II,0,1,0,1,0.0,0.0
Wolfsberg (Aus),0,0,1,1,0.0,6.0
Lierse,11,4,19,34,1.147059,1.794118
Energosbyt-BSATU,0,0,1,1,0.0,7.0
Carlisle,126,95,117,338,1.423077,1.399408
Padova,6,3,6,15,1.0,1.066667
St Mirren,103,64,118,285,1.312281,1.417544
Ventspils,16,9,18,43,1.488372,1.418605
Al Ahly,1,1,1,3,0.333333,0.666667
North Leigh,8,4,8,20,2.15,2.2
Casa Pia,0,0,1,1,0.0,3.0
Hollands and B,0,0,2,2,0.0,1.5
Cammel Laird,0,0,1,1,0.0,5.0
Enfield,2,1,4,7,1.571429,2.428571
Skala,1,1,6,8,0.625,1.875
SC Hauenstein,0,0,1,1,1.0,2.0
L'Aquila,1,0,1,2,1.0,2.5
Chester,89,70,112,271,1.376384,1.487085
Chemnitzer,2,2,5,9,1.111111,2.111111
Mainz II,0,1,2,3,0.333333,1.666667
Bearsted,3,0,2,5,1.8,1.2
FK Belasica,0,0,2,2,0.5,3.5
Sivasspor,68,61,68,197,1.375635,1.380711
Piatra Neamt,3,4,10,17,0.647059,1.529412
Khimki,13,5,10,28,1.357143,1.357143
USA,49,18,23,90,1.911111,0.988889
Syria,20,11,13,44,1.659091,1.25
Sundsvall,39,41,73,153,1.189542,1.614379
Lokeren,47,50,68,165,1.254545,1.442424
Aylesbury,3,4,4,11,2.363636,2.090909
Bosnia-Hz.,23,16,19,58,1.517241,1.172414
Cosenza,7,6,8,21,1.142857,1.333333
Worgl,0,0,1,1,0.0,3.0
Charleroi,104,70,81,255,1.392157,1.203922
Belize,3,4,6,13,1.153846,1.461538
Beith,0,0,1,1,0.0,1.0
Tadcaster Alb.,4,3,10,17,1.294118,1.882353
FC Emmen,23,22,44,89,1.157303,1.966292
Racing Murcia,1,0,1,2,1.5,2.5
Penicuik Athletic,6,0,3,9,2.555556,1.222222
Carmarthen,52,34,83,169,1.319527,1.751479
Jodan Boys,1,0,1,2,1.0,2.5
Mangotsfield,4,1,6,11,1.909091,1.909091
PSG II,1,0,0,1,2.0,1.0
Wiener Viktoria,0,0,1,1,1.0,4.0
Guiseley,76,79,121,276,1.195652,1.543478
Le Pontet US,0,0,1,1,2.0,3.0
Metalist,6,17,15,38,0.815789,1.605263
Rushall Oly.,72,37,63,172,1.575581,1.453488
Cork Celtic,1,0,0,1,1.0,0.0
New Star,0,0,1,1,1.0,2.0
Jeonbuk H M,1,0,1,2,2.5,1.5
Colville Park,1,0,1,2,1.0,5.0
TuS Rot-Weiss Koblenz,0,0,3,3,0.333333,5.0
Deal Town,5,3,5,13,2.076923,2.538462
Eswatini,0,1,2,3,1.0,2.666667
Lyon Duchere,4,3,4,11,1.272727,1.090909
Opatija,0,0,1,1,0.0,3.0
Dnepr Mogilev,10,15,36,61,0.737705,1.655738
Auckland City,0,0,3,3,0.333333,1.666667
Frome,76,51,90,217,1.387097,1.672811
Cherno More,83,52,80,215,1.15814,1.2
Petange,1,0,3,4,0.75,2.5
Gudja United,1,0,0,1,2.0,0.0
Japan,47,16,17,80,2.125,0.9
Terek Grozny,66,54,71,191,1.057592,1.188482
Niki Volos,0,1,18,19,0.0,2.842105
Berkhamsted,10,0,6,16,2.8125,1.75
Germany Women,6,1,2,9,1.777778,0.777778
New Zealand,12,4,13,29,1.37931,1.034483
Witham Town,5,9,20,34,1.0,1.882353
Saint-Priest,0,0,2,2,0.5,3.5
Hapoel Ra'ana,48,56,83,187,0.935829,1.363636
Melksham Town,11,3,6,20,2.0,1.65
Lommel,0,0,2,2,0.5,3.0
Swallownest,0,1,0,1,1.0,1.0
Hekimoglu Trabzon,0,0,1,1,0.0,1.0
Telford,90,57,113,260,1.303846,1.461538
Ghana Women,0,1,0,1,0.0,0.0
Rapid Vienna,128,62,78,268,1.764925,1.246269
Rijeka,146,63,54,263,1.749049,0.927757
Moneyfields,7,2,6,15,1.2,2.2
24 Erzincanspor,0,0,1,1,0.0,3.0
Clipstone,0,0,2,2,0.0,1.5
Mostoles,0,1,0,1,0.0,0.0
Greece U21,0,1,3,4,0.25,1.25
Aberystwyth,64,44,88,196,1.520408,1.852041
Real Madrid,232,67,59,358,2.284916,1.036313
Olimpic,0,1,0,1,1.0,1.0
Urawa Red Diamonds,1,0,0,1,3.0,2.0
Horndean,3,1,5,9,1.333333,1.777778
Longueau,0,1,1,2,0.5,1.5
Wexford Yth,40,27,106,173,1.023121,1.913295
Huntingdon T,0,0,1,1,2.0,4.0
Eintracht Trier,0,0,1,1,0.0,3.0
K Sports,0,0,1,1,3.0,4.0
March Town Utd,0,0,1,1,0.0,1.0
Pineto,0,0,1,1,0.0,1.0
Soloman Islands,5,3,9,17,0.882353,1.470588
FK Klaipedos Granitas,0,0,1,1,0.0,5.0
London Colney,3,1,4,8,2.125,2.0
Latina,2,3,3,8,1.0,1.5
A Mancha R,0,0,1,1,0.0,5.0
Linense,6,3,5,14,1.285714,1.5
CfR Pforzheim,1,0,1,2,2.0,1.5
Exeter,147,84,113,344,1.459302,1.287791
Mt de Marsan Stade,0,0,1,1,0.0,1.0
Flamurtari,1,3,7,11,0.636364,1.636364
Brentford,141,79,108,328,1.582317,1.213415
Ivancsa,0,0,1,1,0.0,3.0
Mossley,4,1,5,10,1.6,2.3
RB Leipzig,144,60,59,263,1.851711,1.144487
Lealtad,0,0,2,2,0.5,1.5
Asteras T.,71,67,80,218,1.105505,1.142202
Renfrew,0,0,4,4,1.0,3.0
Sektzia Nes Tziona,9,8,17,34,0.764706,1.352941
Balham,0,0,1,1,1.0,3.0
Milton Keynes Irish,1,2,0,3,2.333333,1.666667
South Africa Women,0,0,5,5,0.6,3.6
Dulwich H,127,72,87,286,1.692308,1.255245
Liria Prizren,0,0,1,1,1.0,3.0
Eversley & California,0,0,1,1,0.0,1.0
St Liege,117,73,85,275,1.516364,1.287273
Canada,24,11,13,48,2.145833,0.979167
Europa,10,1,12,23,1.478261,1.608696
Algeciras,0,1,0,1,0.0,0.0
Whitehill W,16,8,46,70,1.285714,2.342857
Sunderland RCA,10,1,5,16,2.5625,1.6875
AS Excelsior,0,0,1,1,1.0,4.0
Farense,6,7,15,28,0.928571,1.285714
Mansfield,115,105,112,332,1.286145,1.23494
Ajaccio,9,10,26,45,0.777778,1.422222
V sur Saone,0,0,1,1,0.0,9.0
Virtus Francavilla,2,0,4,6,1.0,2.5
Varzim,0,0,1,1,2.0,4.0
Arbroath,99,68,96,263,1.452471,1.357414
Bewdley Town,0,1,2,3,1.0,2.333333
Broughty,1,0,0,1,3.0,2.0
Perth Glory,73,39,59,171,1.71345,1.561404
West Ham,105,72,112,289,1.394464,1.467128
Hearts U20,7,1,6,14,2.071429,1.785714
Cobham,2,0,3,5,1.4,1.4
Pro Patria,3,0,3,6,1.0,1.666667
Pisa,6,5,7,18,1.555556,1.555556
Thaon,1,0,0,1,4.0,1.0
Clyde,109,48,105,262,1.427481,1.423664
Aberdeen,156,64,83,303,1.50165,1.052805
Knaresborough Town,0,1,2,3,1.666667,2.666667
Spelthorne Sports,1,0,2,3,1.0,1.333333
Seligenporten,0,1,0,1,1.0,1.0
Swaffham Town,2,1,3,6,1.166667,2.166667
N Ireland,22,15,24,61,1.04918,1.065574
Skelmersdale,31,26,69,126,1.238095,2.063492
Stotfold,1,0,1,2,3.0,1.5
Eq Guinea,6,8,14,28,0.785714,1.142857
Bressuire,1,0,1,2,1.0,1.0
Al Duhail,1,0,1,2,1.5,1.0
AlmerÃ­a II,0,0,3,3,0.0,1.333333
Haguenau,1,1,0,2,1.5,1.0
Fougeres AGL,1,0,0,1,3.0,2.0
Charnock Richard,1,0,5,6,2.0,3.333333
Cove,0,0,1,1,0.0,5.0
Rodange,0,0,3,3,0.333333,5.0
Teuta,5,1,9,15,1.2,2.133333
Extremadura,25,25,41,91,1.032967,1.285714
AFC Liverpool,0,0,2,2,0.0,4.5
Ergotelis,6,4,10,20,1.1,1.75
Alsager,2,2,3,7,2.142857,2.0
Empoli,48,44,75,167,1.191617,1.520958
Atherton Colls,23,7,24,54,1.685185,1.62963
Chamalieres,0,1,0,1,0.0,0.0
Dornbirn,0,0,1,1,1.0,5.0
Mildenhall Town,6,1,5,12,1.75,1.416667
Beauvais,5,2,1,8,2.25,1.125
Luton,152,82,109,343,1.510204,1.201166
Sassuolo,94,74,100,268,1.41791,1.492537
West Ham U21,16,3,20,39,1.435897,1.923077
Stade Bordelais,2,0,1,3,1.333333,1.0
Taraz,1,0,7,8,0.375,2.875
Tulevik Viljandi,1,0,5,6,0.333333,2.5
SV Meppen,4,1,2,7,2.0,1.428571
Academica Clinceni,21,24,27,72,1.027778,1.375
St Polten,36,41,87,164,1.067073,1.853659
Hauts Lyonnais,0,1,0,1,0.0,0.0
Holker Old Boys,1,0,2,3,1.0,1.333333
SKF Sered,0,0,5,5,0.6,3.2
Dyn Dresden,51,40,62,153,1.326797,1.496732
Flackwell Heath,5,1,6,12,1.916667,2.25
Bedford,10,6,5,21,1.952381,1.428571
West Didsbury & Chorlton AFC,0,0,3,3,1.333333,3.333333
IBV Vestmann,3,0,5,8,0.875,1.875
Levante II,0,0,1,1,0.0,1.0
Strazske,0,0,1,1,0.0,9.0
B Leverkusen,145,59,88,292,1.835616,1.294521
Rodeo,0,1,1,2,1.0,1.5
Krka,15,14,23,52,0.980769,1.442308
Stenh'semuir,78,53,134,265,1.218868,1.796226
Seaham Red Star,4,1,5,10,1.3,1.5
Worcester,36,37,53,126,1.293651,1.484127
Madagascar,12,14,11,37,1.243243,1.324324
Nuremberg II,0,0,1,1,0.0,2.0
Scarborough,0,0,1,1,0.0,2.0
Club Atletico Antoniano,1,0,1,2,1.0,2.0
Germany U21,17,7,5,29,1.896552,1.0
Albania U21,0,0,1,1,0.0,1.0
Hashtag United,1,1,0,2,1.0,0.0
Revan,1,1,2,4,1.0,1.25
Nordsjaelland,83,55,88,226,1.561947,1.522124
Newcastle Town,4,4,6,14,1.928571,2.5
UE Sant Julia,3,5,11,19,0.736842,1.684211
At Saguntino,1,2,0,3,1.0,0.666667
M'Boro U21,6,0,1,7,2.428571,1.0
Everton U21,10,8,11,29,1.37931,1.172414
Mersin,12,11,30,53,1.207547,1.886792
Prescott Cabl.,6,5,7,18,1.444444,1.444444
Vale of Leithen,18,13,71,102,1.186275,3.303922
Hartlepool,107,78,126,311,1.234727,1.376206
Longlevens,1,1,4,6,1.333333,2.5
Los Angeles FC,50,25,26,101,2.158416,1.435644
Kisvarda,33,23,41,97,1.061856,1.298969
Chania,0,0,1,1,0.0,4.0
N. Chicago,0,0,1,1,1.0,3.0
CSKA Mosc.,122,57,65,244,1.520492,0.946721
Tyumen,0,1,0,1,1.0,1.0
Buckingham Ath,0,1,3,4,2.0,4.0
Sandvikens,0,1,2,3,1.333333,2.666667
Newtown,73,44,87,204,1.529412,1.656863
Valencia,134,81,103,318,1.465409,1.254717
Ponferradina,56,47,65,168,1.029762,1.142857
Stumbras,1,2,6,9,0.666667,2.444444
Juventus Buch,4,10,26,40,0.525,1.8
Bideford,19,20,38,77,1.038961,1.792208
MTK,50,40,59,149,1.127517,1.248322
Karlsruhe,40,45,60,145,1.103448,1.434483
Holmer Green,1,0,1,2,0.5,1.5
Rain-Lech,0,1,0,1,1.0,1.0
Spennymoor,98,54,53,205,1.912195,1.278049
Epinal,7,5,8,20,1.25,1.25
AFC Emley,1,0,2,3,2.0,3.0
Radcliffe Boro,16,6,29,51,1.176471,1.960784
Gravesham Borough,0,0,1,1,0.0,1.0
Shawbury Utd,0,1,2,3,0.333333,2.0
Barnsley U21,0,0,2,2,1.0,5.0
M'well U20,10,0,6,16,1.9375,1.3125
Sweden,37,17,23,77,1.558442,0.922078
Celta Vigo B,1,0,1,2,1.0,1.5
Hungary Women,0,0,1,1,1.0,5.0
AG Caennaise,0,0,1,1,0.0,1.0
Lossiemouth,11,8,88,107,0.962617,3.542056
Tranent,1,0,0,1,4.0,2.0
Minnesota U,48,25,56,129,1.51938,1.697674
Karmiotissa,0,0,1,1,0.0,1.0
Longwell Green Sports,0,0,2,2,1.5,3.5
Walton & H,5,2,4,11,2.181818,1.272727
Mainz,79,51,106,236,1.330508,1.597458
Hienghene Sport,0,0,1,1,1.0,3.0
Dunkerque,2,1,8,11,1.090909,1.818182
Cadbury Athletic,2,0,4,6,1.833333,3.5
Bridlington T,2,1,4,7,1.714286,2.714286
Crook Town,0,0,1,1,2.0,4.0
US Sinnamary,0,1,0,1,1.0,1.0
Chippenham,111,64,87,262,1.51145,1.343511
Lucan United,0,0,1,1,1.0,3.0
Burscough,4,1,4,9,1.555556,1.444444
Cottesmore Amateurs S&S,0,0,1,1,1.0,3.0
Tondela,54,43,101,198,1.030303,1.510101
VVV Venlo,32,29,63,124,1.169355,1.975806
Montreal Imp,70,36,86,192,1.458333,1.65625
Poissy,0,0,2,2,0.0,2.0
Norwich CBS,5,0,3,8,2.0,2.375
Red Star,221,47,33,301,2.252492,0.790698
Energetik B.,0,0,1,1,1.0,2.0
SC Freiburg (Am),1,0,1,2,1.5,1.5
South Shields,74,19,22,115,2.208696,1.104348
Largs Athletic,0,0,2,2,0.0,2.0
Borrowash Vics,0,1,0,1,3.0,3.0
Faetano,1,0,1,2,1.0,1.5
Ireland Women,0,0,1,1,1.0,2.0
Cercle Bruges,29,14,74,117,1.102564,1.871795
Beaconsfield,25,25,44,94,1.191489,1.702128
Enosis,1,2,5,8,0.75,2.625
Miengo,0,0,1,1,0.0,1.0
Fola Esch,19,6,18,43,1.953488,1.72093
Samtredia,5,1,10,16,1.0625,1.875
Iran,41,13,8,62,2.0,0.548387
MTV Eintracht Celle,0,0,1,1,0.0,7.0
Bastia-Borgo,0,0,1,1,0.0,3.0
Albalonga,0,0,1,1,1.0,2.0
Penistone Church,1,1,2,4,1.5,1.25
Ternana,4,4,8,16,0.9375,1.25
Roman Glass St George,2,0,3,5,1.8,2.4
Bridon Ropes,0,0,2,2,1.5,2.5
Freiburger,0,0,1,1,0.0,5.0
Proleter Novi Sad,29,27,44,100,0.92,1.26
Falmouth Town,5,1,2,8,2.875,1.625
Teteks,0,0,1,1,1.0,2.0
Hednesford,69,50,94,213,1.352113,1.58216
Paide Linnameeskond,0,0,1,1,0.0,2.0
Loxwood,1,0,1,2,1.5,1.5
Shukura,0,1,3,4,1.0,2.5
Sidlesham,0,0,1,1,0.0,2.0
Inhulets Petrove,3,11,8,22,0.909091,1.5
Broxburn Ath,6,3,5,14,1.714286,1.642857
Vanuatu,4,3,5,12,4.75,1.833333
Pecsi Munkas,6,3,4,13,1.230769,1.307692
U da Madeira,7,8,19,34,0.794118,1.470588
Codicote,0,0,1,1,1.0,7.0
Besancon,0,0,2,2,0.5,3.0
Stranraer,94,51,114,259,1.362934,1.583012
Tre Fiori,0,0,12,12,0.25,3.166667
Bokelj,0,2,3,5,0.4,1.8
Haverhill Rov,0,0,1,1,0.0,2.0
Ajax,199,55,45,299,2.384615,0.862876
Bromsgrove S,8,3,5,16,2.0625,1.5
Willem II,65,49,98,212,1.259434,1.679245
Nigeria,26,14,15,55,1.327273,0.872727
Reggina,2,1,2,5,1.0,1.2
Bardon Hill Sports,0,0,1,1,3.0,4.0
Orgryte,0,0,3,3,0.0,2.0
Elburton Villa,0,0,1,1,0.0,2.0
Rapid Buch.,6,4,7,17,0.823529,1.058824
New Salamis,0,0,2,2,1.0,4.5
NK Siroki Brijeg,4,7,8,19,0.789474,1.052632
Calne Town,0,0,2,2,1.0,4.0
Cavese,0,0,1,1,1.0,3.0
Winterthur,1,0,0,1,1.0,0.0
KF Drita,4,2,6,12,1.083333,1.583333
Vaduz,40,43,72,155,1.232258,1.690323
Korea Republic Olympic,2,1,1,4,3.0,1.0
Lanciano,0,4,3,7,0.571429,1.285714
Ostersunds FK,64,44,61,169,1.35503,1.360947
Belfort,5,2,5,12,1.083333,1.166667
Lund,0,0,1,1,0.0,2.0
Pontevedra,1,1,5,7,0.285714,1.142857
Harpenden T,0,0,2,2,0.0,4.0
Irchester United,1,0,1,2,1.5,2.0
Nantwich,120,64,83,267,1.696629,1.389513
Bursaspor,53,36,67,156,1.25641,1.435897
Malaga,82,75,116,273,0.992674,1.153846
Swaziland,7,5,10,22,0.909091,1.454545
Cove Rangers,119,22,34,175,2.514286,0.96
Partick U20,5,2,2,9,2.444444,1.555556
Chertsey Town,10,2,3,15,2.666667,0.866667
Loko. Tbilisi,4,0,4,8,1.0,1.625
Union Titus Petange,0,0,1,1,0.0,2.0
Petersfield Town,1,1,5,7,0.857143,2.285714
Stokesley,0,0,1,1,1.0,7.0
Penybont,17,12,23,52,1.288462,1.538462
Antigua & Barb,7,2,7,16,1.75,1.5625
Glasgow United,0,0,1,1,1.0,2.0
Wembley,3,0,3,6,2.666667,2.5
Barton T OB,1,0,1,2,4.0,1.0
Ruzomberok,11,3,14,28,1.357143,1.428571
Helsingor,8,3,21,32,0.875,1.90625
Aris Salonika,44,27,38,109,1.311927,1.110092
Gambia,4,7,6,17,0.764706,1.235294
Loko. Zagreb,90,54,99,243,1.325103,1.37037
Jarrow Roofing,0,0,2,2,0.5,4.0
Nesebar,0,0,1,1,1.0,3.0
S Normanton A,3,0,2,5,1.6,1.2
Argentina Women,1,3,4,8,0.875,2.0
Sudtirol,7,0,7,14,1.428571,1.714286
Laos,1,2,11,14,0.5,3.214286
Musselburgh Ath,2,0,0,2,4.0,1.5
Gorleston,5,1,4,10,2.6,2.3
Eskilsminne IF ,0,0,3,3,0.333333,4.333333
FK Atyrau,0,2,7,9,0.444444,2.777778
Panazol,0,0,1,1,0.0,3.0
Fulham U21,8,7,21,36,1.583333,2.111111
Jaen,2,3,0,5,1.8,1.0
Dorking W,81,32,49,162,1.901235,1.339506
Ravan Baku,0,0,1,1,0.0,3.0
Atzeneta,0,0,1,1,0.0,1.0
Bradford,125,96,121,342,1.210526,1.236842
South Korea Women,2,1,5,8,1.375,1.625
FC Broxbourne Borough,3,0,2,5,2.0,2.4
Singapore,7,6,13,26,0.961538,1.538462
Jonava,1,1,2,4,0.75,2.0
Cameroon Women,3,0,5,8,1.125,2.0
Socuellamos,2,0,4,6,0.833333,1.666667
England U21,12,4,9,25,2.0,1.24
Iraq,23,17,14,54,1.388889,1.074074
Croatia U21,10,5,7,22,2.181818,1.409091
Reggiana,4,2,5,11,1.363636,1.818182
Evian,11,8,19,38,1.131579,1.342105
Unionistas,4,3,2,9,1.777778,1.0
Hastings Utd,8,3,8,19,1.736842,1.684211
Lori,0,1,0,1,2.0,2.0
Stade Briochin,2,3,1,6,1.0,0.833333
R-W Erfurt,0,1,2,3,0.333333,2.333333
Barakaldo,7,7,5,19,1.315789,1.052632
Radcliffe Olym,0,0,1,1,1.0,3.0
Gibraltar,5,3,38,46,0.391304,3.565217
VfB Eichstatt,0,0,1,1,1.0,5.0
Ferencvaros,148,65,39,252,1.880952,0.93254
Harrow Boro,87,54,112,253,1.55336,1.743083
Kansas City,79,52,64,195,1.482051,1.302564
Newmarket,0,0,3,3,0.666667,3.333333
AFC Blackpool,0,0,1,1,3.0,4.0
Gretna,0,0,1,1,1.0,2.0
FC Giessen,0,0,1,1,0.0,2.0
Sturm Graz,97,49,85,231,1.428571,1.277056
Lleida,4,1,2,7,1.285714,0.857143
FK Montana,0,0,1,1,0.0,4.0
Lopes Tavares London,0,0,1,1,2.0,3.0
Club America,7,5,5,17,1.705882,1.176471
Illkirch Graffenstaden,0,1,0,1,3.0,3.0
CPBB Rennes,0,0,1,1,1.0,4.0
Darlington Railway Athletic,0,0,1,1,0.0,4.0
Martinique,10,2,7,19,1.631579,1.105263
Torpedo Zh,86,47,57,190,1.363158,1.042105
Iceland,30,14,34,78,1.307692,1.512821
Cartagena,18,19,23,60,1.066667,1.283333
Skonto Riga,8,2,3,13,1.846154,1.461538
Korona Kielce,63,60,80,203,1.137931,1.433498
